"edon","pan","pric","prdc","pna","asdc","efec","ife","inegi"
1,132358,80694,51125,15548,8703,288428,1001,1001
1,5946,2969,2865,505,182,12467,1002,1002
1,9875,3094,3035,661,405,17070,1003,1003
1,2181,1517,725,285,47,4755,1004,1004
1,10885,6352,2751,988,485,21461,1005,1005
1,3892,3961,2999,1361,240,12453,1006,1006
1,6128,3579,2641,1118,291,13757,1007,1007
1,1079,634,865,203,99,2880,1008,1008
1,2721,1479,926,281,52,5459,1009,1009
1,3881,2670,1759,471,177,8958,1010,1011
1,1737,2071,1027,340,58,5233,1011,1010
2,54324,30459,39489,6356,2554,133182,2001,2001
2,131017,80959,50049,21061,7710,290796,2002,2002
2,12739,8063,6506,2073,761,30142,2003,2003
2,208374,108694,79675,29558,11677,437978,2004,2004
2,10085,5281,5895,1632,581,23474,2005,2005
3,7681,4481,10569,724,406,23861,3001,3001
3,4470,4122,7686,571,333,17182,3002,3002
3,21422,20114,36881,3723,2408,84548,3003,3003
3,15140,6188,19760,1505,1023,43616,3004,3008
3,1990,750,1664,191,88,4683,3005,3009
4,38100,34143,23038,6291,1295,102867,4001,4002
4,7372,9145,3846,2816,154,23333,4002,4001
4,26091,24497,15663,1277,399,67927,4003,4003
4,10612,10924,4857,1925,237,28555,4004,4004
4,1920,5160,1207,4646,65,12998,4005,4005
4,4575,5702,1625,1213,75,13190,4006,4006
4,440,1538,1339,151,30,3498,4007,4007
4,1605,2226,335,267,36,4469,4008,4008
4,3722,5065,6155,1989,107,17038,4009,4009
4,4783,4239,1960,178,41,11201,4010,4011
4,861,2808,3423,115,96,7303,4011,4010
5,224,229,43,24,2,522,5001,5001
5,11543,11440,6348,3838,486,33655,5002,5002
5,3686,2458,671,410,83,7308,5003,5003
5,1755,3830,681,440,76,6782,5004,5004
5,257,454,41,13,2,767,5005,5005
5,2274,3169,1912,374,86,7815,5006,5006
5,835,1955,853,51,24,3718,5007,5007
5,246,485,88,18,6,843,5008,5008
5,2939,6745,8553,1053,160,19450,5009,5009
5,9795,7406,4630,587,309,22727,5010,5010
5,925,1734,386,190,27,3262,5011,5011
5,309,376,36,12,3,736,5012,5012
5,88,296,53,8,3,448,5013,5013
5,588,1375,548,128,32,2671,5014,5014
5,161,238,27,95,0,521,5015,5015
5,303,287,151,9,2,752,5016,5016
5,9674,15042,9838,703,406,35663,5017,5017
5,30921,25056,13337,4321,1235,74870,5018,5018
5,1269,1123,425,100,13,2930,5019,5019
5,6189,10543,4272,687,358,22049,5020,5020
5,610,829,391,29,15,1874,5021,5021
5,2844,2467,924,182,102,6519,5022,5022
5,403,1139,994,38,23,2597,5023,5023
5,4070,5547,2533,564,241,12955,5024,5024
5,19483,18470,8003,1617,674,48247,5025,5025
5,269,665,132,46,14,1126,5026,5026
5,8636,4808,1740,943,282,16409,5027,5027
5,6688,6319,2373,3484,243,19107,5028,5028
5,122,384,356,56,8,926,5029,5029
5,96813,95326,26381,10496,4217,233233,5030,5030
5,2493,2509,1404,217,79,6702,5031,5031
5,5141,6849,2736,756,236,15718,5032,5032
5,2365,13524,20519,713,174,37295,5033,5033
5,435,498,167,18,22,1140,5034,5034
5,121229,68714,42148,6781,3804,242676,5035,5035
5,1352,3923,1644,59,46,7024,5036,5036
5,837,836,104,81,18,1876,5037,5037
5,2030,1415,292,154,36,3927,5038,5038
6,28026,26145,9958,1524,551,66204,6001,6002
6,4132,4174,743,89,47,9185,6002,6003
6,3345,4057,652,146,30,8230,6003,6004
6,3708,4959,3332,191,74,12264,6004,6005
6,16626,14887,5611,1028,355,38507,6005,6010
6,3477,4212,2398,276,33,10396,6006,6001
6,605,1428,707,31,15,2786,6007,6006
6,33953,17802,4743,1333,452,58283,6008,6007
6,1459,1483,433,122,16,3513,6009,6008
6,15858,17211,4115,860,170,38214,6010,6009
7,889,1254,1342,205,35,3725,7001,7001
7,1881,2503,2524,158,40,7106,7002,7002
7,1696,1627,2806,324,57,6510,7003,7003
7,280,3019,2290,63,52,5704,7004,7004
7,915,2187,1389,34,25,4550,7005,7005
7,559,2742,3808,63,53,7225,7006,7006
7,50,884,588,9,5,1536,7007,7007
7,1366,2570,2251,38,40,6265,7008,7008
7,4700,3213,3698,1104,127,12842,7009,7009
7,49,807,463,11,2,1332,7010,7010
7,222,2547,1807,67,9,4652,7011,7011
7,1864,2712,3078,355,94,8103,7012,7012
7,519,4405,2367,157,146,7594,7013,7013
7,306,1592,730,58,22,2708,7014,7014
7,1646,4108,5827,173,118,11872,7015,7015
7,478,2647,3064,69,197,6455,7016,7016
7,2696,5857,10197,1555,200,20505,7017,7017
7,166,1240,1089,28,13,2536,7018,7018
7,3829,17226,9880,1628,397,32960,7019,7019
7,1503,4435,3830,88,89,9945,7020,7020
7,1478,2154,1785,108,69,5594,7021,7021
7,513,1260,1001,19,25,2818,7022,7022
7,885,10691,3439,191,84,15290,7023,7023
7,276,1490,762,10,9,2547,7024,7024
7,523,850,816,16,25,2230,7025,7025
7,602,4910,791,16,32,6351,7026,7026
7,4483,7357,8884,753,196,21673,7027,7027
7,353,531,539,17,5,1445,7028,7028
7,695,662,380,22,3,1762,7029,7029
7,538,3243,3596,84,35,7496,7030,7030
7,963,12047,12547,59,69,25685,7031,7031
7,1864,2096,2811,439,47,7257,7032,7032
7,736,337,858,5,8,1944,7033,7033
7,1001,4659,5222,282,89,11253,7034,7034
7,675,1244,1127,53,35,3134,7035,7035
7,76,733,675,19,14,1517,7036,7036
7,1388,3438,4932,198,96,10052,7037,7037
7,226,2529,1857,22,15,4649,7038,7039
7,612,2335,1973,37,15,4972,7039,7038
7,6532,4379,3830,341,117,15199,7040,7040
7,692,3113,1905,380,52,6142,7041,7041
7,203,1054,1064,16,6,2343,7042,7042
7,734,1357,1038,51,24,3204,7043,7043
7,504,2750,3807,278,38,7377,7044,7044
7,629,662,344,15,8,1658,7045,7045
7,928,3923,7073,342,76,12342,7046,7046
7,211,2069,3015,31,23,5349,7047,7047
7,945,2652,2808,140,62,6607,7048,7048
7,207,3338,351,25,30,3951,7049,7049
7,1297,855,497,12,16,2677,7050,7050
7,2934,2698,3535,326,99,9592,7051,7051
7,873,9931,16567,261,168,27800,7052,7052
7,99,1094,913,26,4,2136,7053,7053
7,1134,2811,3971,109,62,8087,7054,7054
7,608,654,682,23,12,1979,7055,7055
7,156,1175,390,18,20,1759,7056,7056
7,1235,6411,5626,319,161,13752,7057,7057
7,2,69,786,0,1,858,7058,7058
7,3037,18926,13095,484,307,35849,7059,7059
7,201,1489,1072,15,12,2789,7060,7060
7,5705,6742,5645,486,204,18782,7061,7061
7,924,2128,1384,227,41,4704,7062,7062
7,492,552,203,17,8,1272,7063,7063
7,551,7321,3690,136,57,11755,7064,7064
7,2662,9887,13854,567,325,27295,7065,7065
7,88,2515,1449,25,14,4091,7066,7066
7,499,1343,1544,9,12,3407,7067,7067
7,2304,4142,4009,317,114,10886,7068,7068
7,3967,4128,4872,541,112,13620,7069,7069
7,148,1916,1086,14,11,3175,7070,7070
7,930,3238,4531,33,25,8757,7071,7072
7,731,750,754,35,22,2292,7072,7073
7,1129,4431,7371,370,184,13485,7073,7074
7,1251,1530,1751,132,37,4701,7074,7075
7,271,3896,2683,17,25,6892,7075,7076
7,653,7349,5124,127,77,13330,7076,7077
7,8717,18045,17645,1801,917,47125,7077,7078
7,1862,2295,2126,265,57,6605,7078,7079
7,334,3130,2275,19,25,5783,7079,7112
7,337,735,554,8,16,1650,7080,7110
7,363,3474,3971,49,32,7889,7081,7080
7,520,3922,2287,74,31,6834,7082,7081
7,66,1301,1714,4,9,3094,7083,7082
7,291,1391,1979,52,29,3742,7084,7083
7,198,1099,1016,38,13,2364,7085,7084
7,185,1270,1376,45,18,2894,7086,7085
7,1283,1161,2313,170,35,4962,7087,7086
7,1928,2463,2769,289,119,7568,7088,7087
7,103,545,165,4,2,819,7089,7088
7,18292,32964,31757,2832,1303,87148,7090,7089
7,59,875,675,4,4,1617,7091,7090
7,732,1291,1292,60,24,3399,7092,7091
7,1335,4968,3127,135,231,9796,7093,7092
7,635,4546,2133,133,40,7487,7094,7093
7,983,2806,1633,103,49,5574,7095,7094
7,961,8361,5282,81,149,14834,7096,7096
7,10599,6051,6865,3679,399,27593,7097,7097
7,129,583,537,52,5,1306,7098,7098
7,1349,5924,8927,323,128,16651,7099,7099
7,648,4681,2597,95,44,8065,7100,7100
7,3381,4577,3017,287,106,11368,7101,7102
7,49594,49621,66873,5067,2950,174105,7102,7101
7,2619,1925,2720,60,38,7362,7103,7103
7,420,1809,1280,29,13,3551,7104,7104
7,764,1628,2113,61,38,4604,7105,7105
7,1662,3905,5163,289,110,11129,7106,7106
7,1233,2281,2887,695,84,7180,7107,7071
7,3506,5921,7384,249,120,17180,7108,7107
7,6591,9264,9451,539,223,26068,7109,7108
7,993,3929,2093,57,67,7139,7110,7109
7,612,4455,6322,43,28,11460,7111,7111
7,119,917,40,9,6,1091,7112,7113
7,462,1559,1412,65,35,3533,7113,7114
7,206,641,484,7,6,1344,7114,7115
7,327,615,1013,37,20,2012,7115,7116
7,898,839,283,23,7,2050,7116,7117
7,274,433,301,0,0,1008,7117,7118
7,122,616,209,1,1,949,7118,7119
7,NA,NA,NA,NA,NA,NA,7120,7123
7,NA,NA,NA,NA,NA,NA,7121,7124
7,NA,NA,NA,NA,NA,NA,7122,7122
7,NA,NA,NA,NA,NA,NA,7123,7120
7,NA,NA,NA,NA,NA,NA,7124,7121
8,1532,1923,625,282,71,4433,8001,8001
8,3308,3221,920,380,95,7924,8002,8002
8,1150,1652,289,234,21,3346,8003,8003
8,500,681,171,106,15,1473,8004,8004
8,2583,2692,1307,331,96,7009,8005,8005
8,451,973,886,75,9,2394,8006,8006
8,1387,2210,304,106,41,4048,8007,8007
8,633,1284,140,40,13,2110,8008,8008
8,2072,3497,1397,771,119,7856,8009,8009
8,2044,3912,1249,248,57,7510,8010,8010
8,9258,6345,1753,941,235,18532,8011,8011
8,373,1460,295,62,20,2210,8012,8012
8,1297,1943,646,123,37,4046,8013,8013
8,505,474,43,15,3,1040,8014,8014
8,282,297,54,7,3,643,8015,8015
8,845,649,85,39,11,1629,8016,8016
8,11663,18613,13288,1639,370,45573,8017,8017
8,384,781,456,46,17,1684,8018,8018
8,142765,114111,33632,15950,3578,310036,8019,8019
8,551,645,122,124,9,1451,8020,8020
8,19127,23195,4404,2091,489,49306,8021,8021
8,613,610,184,34,15,1456,8022,8022
8,424,694,196,33,7,1354,8023,8023
8,716,621,218,54,15,1624,8024,8024
8,817,1551,620,88,27,3103,8025,8025
8,433,788,203,54,18,1496,8026,8026
8,2512,4805,1295,659,128,9399,8027,8027
8,938,1357,778,134,45,3252,8028,8028
8,2242,5039,1026,543,73,8923,8029,8029
8,811,988,244,77,8,2128,8030,8030
8,2913,6638,2851,702,107,13211,8031,8031
8,18992,16798,4042,2102,420,42354,8032,8032
8,190,290,6,2,0,488,8033,8033
8,481,1316,781,70,14,2662,8034,8034
8,711,1226,448,128,38,2551,8035,8035
8,5742,5669,2394,812,128,14745,8036,8036
8,166466,148375,61529,23360,9720,409450,8037,8037
8,963,874,131,97,8,2073,8038,8038
8,596,631,379,49,9,1664,8039,8039
8,4371,4904,1045,427,92,10839,8040,8040
8,192,383,21,21,1,618,8041,8041
8,253,267,45,7,4,576,8042,8042
8,426,580,224,22,12,1264,8043,8043
8,755,721,177,74,10,1737,8044,8044
8,6610,5467,1647,810,156,14690,8045,8045
8,435,754,65,17,9,1280,8046,8046
8,645,860,63,18,10,1596,8047,8047
8,2274,2928,1796,240,35,7273,8048,8048
8,434,647,38,26,5,1150,8049,8049
8,8115,8637,3678,965,309,21704,8050,8050
8,588,1316,200,46,9,2159,8051,8051
8,4546,3265,1276,223,83,9393,8052,8052
8,1313,1238,604,89,41,3285,8053,8053
8,295,463,193,196,4,1151,8054,8054
8,2537,2511,518,272,44,5882,8055,8055
8,185,335,112,15,8,655,8056,8056
8,603,484,94,23,5,1209,8057,8057
8,575,375,267,67,14,1298,8058,8058
8,809,933,261,224,37,2264,8059,8059
8,1831,1819,449,333,68,4500,8060,8060
8,903,817,91,58,6,1875,8061,8061
8,6250,4418,1083,468,107,12326,8062,8062
8,571,1288,256,65,15,2195,8063,8063
8,271,425,24,7,2,729,8064,8064
8,1121,1915,316,251,30,3633,8065,8065
8,613,931,379,80,10,2013,8066,8066
8,619,1114,132,99,10,1974,8067,8067
9,77633,33278,131856,13618,9438,265823,9002,9002
9,120750,44412,187288,17099,17082,386631,9003,9003
9,24867,10939,33311,6185,3635,78937,9004,9004
9,165493,78761,371613,34990,25537,676394,9005,9005
9,54825,27984,129406,13393,8365,233973,9006,9006
9,165940,94163,514987,48090,34915,858095,9007,9007
9,30081,13780,67185,6604,4760,122410,9008,9008
9,6741,9588,26685,3619,1564,48197,9009,9009
9,108436,37302,195651,18835,14665,374889,9010,9010
9,23375,24301,88643,8705,5941,150965,9011,9011
9,87726,35286,175563,14535,12943,326053,9012,9012
9,36003,19709,111278,11451,7585,186026,9013,9013
9,107724,29299,76374,9459,11725,234581,9014,9014
9,81455,41256,147780,14926,13291,298708,9015,9015
9,84601,27016,80270,8982,6279,207148,9016,9016
9,67045,34454,134884,15941,10808,263132,9017,9017
10,4489,4340,2260,484,134,11707,10001,10001
10,375,411,250,63,5,1104,10002,10002
10,368,800,298,40,8,1514,10003,10003
10,4792,3900,1533,586,92,10903,10004,10004
10,87446,66283,33694,8551,2248,198222,10005,10005
10,1065,1674,963,72,22,3796,10006,10006
10,32274,55789,19109,1894,1050,110116,10007,10007
10,4072,4135,4127,422,82,12838,10008,10008
10,1817,1942,280,49,15,4103,10009,10009
10,951,785,104,37,8,1885,10010,10010
10,1081,840,197,59,18,2195,10011,10011
10,20591,19944,8955,975,393,50858,10012,10012
10,3023,2569,2215,138,75,8020,10013,10013
10,3834,5034,523,88,65,9544,10014,10014
10,1459,1518,1751,100,35,4863,10015,10015
10,2384,2189,1442,233,66,6314,10016,10016
10,3034,3313,980,275,66,7668,10017,10039
10,1596,1987,333,164,17,4097,10018,10017
10,2096,1799,476,358,32,4761,10019,10018
10,604,555,572,10,3,1744,10020,10019
10,1312,2021,957,263,32,4585,10021,10020
10,1488,1317,884,265,22,3976,10022,10021
10,3070,3392,2412,477,76,9427,10023,10022
10,5279,5778,1335,458,54,12904,10024,10023
10,1796,1702,806,192,26,4522,10025,10024
10,458,837,152,104,9,1560,10026,10025
10,2260,2317,809,169,27,5582,10027,10026
10,1010,746,187,12,12,1967,10028,10027
10,1461,2218,445,217,30,4371,10029,10028
10,401,456,29,18,0,904,10030,10029
10,280,319,93,10,0,702,10031,10030
10,1149,931,505,59,17,2661,10032,10031
10,7093,6791,1574,965,120,16543,10033,10032
10,777,830,633,62,21,2323,10034,10033
10,1369,3100,555,42,17,5083,10035,10034
10,2028,1943,354,171,34,4530,10036,10035
10,2036,2402,3259,376,72,8145,10037,10036
10,773,991,272,33,21,2090,10038,10037
10,2820,2632,1120,312,83,6967,10039,10038
11,15158,9013,3871,839,294,29175,11001,11001
11,17142,5439,17223,1341,744,41889,11002,11002
11,28972,5575,11794,1636,956,48933,11003,11003
11,8758,5126,4999,539,451,19873,11004,11004
11,13486,5389,5333,796,613,25617,11005,11005
11,954,1047,159,20,39,2219,11006,11006
11,102457,28082,18720,6153,5180,160592,11007,11007
11,5324,6162,1467,293,174,13420,11008,11008
11,12151,6546,2493,760,266,22216,11009,11009
11,2256,849,1403,171,56,4735,11010,11010
11,20410,4726,4617,2761,615,33129,11011,11011
11,4088,3426,1842,226,106,9688,11012,11012
11,3481,1119,995,355,1480,7430,11013,11013
11,24975,10479,5070,1592,859,42975,11014,11014
11,26850,21285,6744,2460,1505,58844,11015,11015
11,3288,2604,1476,142,114,7624,11016,11016
11,104170,41335,18955,5009,2609,172078,11017,11017
11,7862,3539,2120,521,131,14173,11018,11018
11,5638,5814,2960,739,279,15430,11019,11019
11,347138,106557,38606,15582,10779,518662,11020,11020
11,12211,4065,2774,793,399,20242,11021,11021
11,4532,2331,355,75,54,7347,11022,11022
11,30073,12340,8227,1264,512,52416,11023,11023
11,2332,1358,996,64,474,5224,11024,11024
11,13867,5508,928,306,162,20771,11025,11025
11,7706,3724,4257,2314,122,18123,11026,11026
11,61452,23244,13230,2623,1609,102158,11027,11027
11,16821,6979,8806,1906,1155,35667,11028,11028
11,5456,2213,2419,117,470,10675,11029,11029
11,17927,8067,3300,586,362,30242,11030,11030
11,28354,11843,2728,769,350,44044,11031,11031
11,13483,3222,4760,1030,378,22873,11032,11032
11,14403,6885,9052,460,654,31454,11033,11033
11,999,833,164,11,12,2019,11034,11034
11,14577,5717,3458,1740,401,25893,11035,11035
11,1211,1017,857,65,17,3167,11036,11036
11,27570,12699,8671,1932,858,51730,11037,11037
11,2644,1432,587,109,51,4823,11038,11038
11,7111,3385,2821,353,155,13825,11039,11039
11,2239,1571,1541,81,190,5622,11040,11040
11,10552,6362,2254,764,332,20264,11041,11041
11,20865,6323,17361,1997,769,47315,11042,11042
11,3023,2841,911,66,42,6883,11043,11043
11,12579,4032,2189,902,636,20338,11044,11044
11,2123,1797,217,7,18,4162,11045,11045
11,10326,9491,4102,972,480,25371,11046,11046
12,41620,53646,116749,16535,6133,234683,12001,12001
12,252,3783,2135,21,34,6225,12002,12002
12,1127,3891,6661,167,54,11900,12003,12003
12,121,1828,2072,34,27,4082,12004,12004
12,87,744,686,81,16,1614,12005,12005
12,450,1644,2106,80,19,4299,12006,12006
12,638,4106,5958,233,73,11008,12007,12007
12,224,1118,1290,82,23,2737,12008,12008
12,165,318,470,12,2,967,12009,12009
12,260,1439,2695,68,41,4503,12010,12010
12,1320,4849,10394,1616,357,18536,12011,12011
12,428,2535,6956,628,63,10610,12012,12012
12,220,2441,3658,263,47,6629,12013,12013
12,360,1580,3005,1234,27,6206,12014,12014
12,1697,1434,1619,156,57,4963,12015,12015
12,125,1614,2224,150,6,4119,12016,12016
12,590,2015,2411,121,40,5177,12017,12017
12,274,1083,1697,207,26,3287,12018,12018
12,219,1394,1134,15,17,2779,12019,12019
12,174,1323,1535,81,17,3130,12020,12020
12,2244,5988,9141,2652,178,20203,12021,12021
12,2017,5894,5287,589,78,13865,12022,12022
12,531,2409,3663,330,62,6995,12023,12023
12,56,1019,1007,29,6,2117,12024,12024
12,155,1710,2230,124,27,4246,12025,12025
12,156,1527,1758,29,4,3474,12026,12026
12,864,2850,3652,60,34,7460,12027,12027
12,2570,10829,13330,755,343,27827,12028,12028
12,9928,29528,26909,3773,1051,71189,12029,12029
12,1344,4033,5396,1722,103,12598,12030,12075
12,331,1551,2409,919,19,5229,12031,12030
12,107,1168,1004,33,12,2324,12032,12031
12,1399,2649,2489,218,38,6793,12033,12032
12,309,1406,1596,73,26,3410,12034,12033
12,1631,4561,4929,379,125,11625,12035,12034
12,8473,14831,19662,2455,980,46401,12036,12035
12,338,916,1298,224,22,2798,12037,12036
12,153,1081,1430,37,13,2714,12038,12037
12,6308,6098,18725,1666,569,33366,12039,12038
12,666,2443,3882,240,59,7290,12040,12039
12,895,2007,1939,167,28,5036,12041,12040
12,218,2696,5832,66,43,8855,12042,12041
12,297,1700,1635,69,48,3749,12043,12042
12,324,1921,6000,53,79,8377,12044,12043
12,576,1387,1315,201,22,3501,12045,12044
12,442,3018,2987,99,42,6588,12046,12045
12,790,7329,8033,400,108,16660,12047,12046
12,199,1083,1030,22,5,2339,12048,12047
12,1536,3217,7974,714,90,13531,12049,12048
12,1414,853,1313,108,66,3754,12050,12049
12,2029,3651,6717,454,148,12999,12051,12050
12,1236,2128,4318,181,80,7943,12052,12051
12,1038,1786,3858,130,69,6881,12053,12052
12,1720,4203,5407,382,82,11794,12054,12053
12,332,2972,4538,128,27,7997,12055,12054
12,13683,11723,9980,1391,738,37515,12056,12055
12,810,2141,5279,567,110,8907,12057,12056
12,1580,4566,13247,1411,130,20934,12058,12057
12,1685,4350,8902,792,301,16030,12059,12058
12,1066,3866,4098,326,80,9436,12060,12059
12,952,1683,1188,135,44,4002,12061,12060
12,1088,2983,4373,1515,123,10082,12062,12061
12,1160,1293,1899,95,27,4474,12063,12062
12,115,1072,1210,39,8,2444,12064,12063
12,1352,1208,2293,74,13,4940,12065,12064
12,122,1163,602,39,12,1938,12066,12065
12,1017,5138,7068,1088,171,14482,12067,12066
12,650,2891,3765,440,27,7773,12068,12067
12,390,4546,5088,240,45,10309,12069,12068
12,355,837,1781,27,17,3017,12070,12069
12,210,789,1051,37,21,2108,12071,12070
12,827,4368,3310,58,35,8598,12072,12071
12,105,961,687,68,13,1834,12073,12072
12,693,1493,4409,116,23,6734,12074,12073
12,838,2688,2550,93,45,6214,12075,12074
12,277,1663,3994,31,36,6001,12076,12076
12,NA,NA,NA,NA,NA,NA,12077,12079
12,NA,NA,NA,NA,NA,NA,12078,12081
12,NA,NA,NA,NA,NA,NA,12079,12078
12,202,962,1977,232,20,3393,12080,12077
12,NA,NA,NA,NA,NA,NA,12081,12080
13,1740,2371,1328,206,77,5722,13001,13001
13,2681,3749,3196,384,128,10138,13002,13002
13,3377,7120,8251,1021,282,20051,13003,13003
13,1172,1247,737,145,21,3322,13004,13004
13,999,2273,2485,277,101,6135,13005,13005
13,1134,2797,2560,291,120,6902,13006,13006
13,1297,1666,721,131,81,3896,13007,13007
13,3647,6490,4527,888,241,15793,13008,13008
13,3197,3070,3079,374,198,9918,13009,13010
13,708,2705,3131,465,47,7056,13010,13011
13,3178,2811,2052,1129,135,9305,13011,13012
13,2723,3269,4712,588,234,11526,13012,13013
13,1820,2904,1403,333,42,6502,13013,13014
13,776,2548,2244,414,55,6037,13014,13015
13,6812,4741,3912,768,309,16542,13015,13016
13,919,1774,1491,215,59,4458,13016,13017
13,793,3717,2919,231,48,7708,13017,13018
13,500,2642,2380,345,75,5942,13018,13019
13,1196,2653,1693,254,56,5852,13019,13009
13,71,514,656,26,6,1273,13020,13020
13,828,1861,2319,314,91,5413,13021,13021
13,1793,1182,1325,419,91,4810,13022,13022
13,1189,4017,5768,1637,150,12761,13023,13023
13,1382,1805,1717,359,65,5328,13024,13024
13,758,3214,3985,538,67,8562,13025,13025
13,425,1425,1909,278,69,4106,13026,13026
13,650,3996,2880,234,44,7804,13027,13027
13,5685,12810,14043,3251,363,36152,13028,13028
13,4584,6626,2908,1044,265,15427,13029,13029
13,4160,10875,12045,1374,354,28808,13030,13030
13,662,1627,1884,242,41,4456,13031,13031
13,676,1453,1794,228,27,4178,13032,13032
13,43,759,539,20,2,1363,13033,13033
13,348,1424,1912,46,16,3746,13034,13040
13,785,1261,957,256,22,3281,13035,13034
13,1009,1292,1187,185,54,3727,13036,13035
13,578,3263,2145,438,35,6459,13037,13037
13,404,1064,1145,214,47,2874,13038,13038
13,1060,2071,1417,592,210,5350,13039,13039
13,11155,8235,6862,2029,829,29110,13040,13051
13,3160,4806,4417,1179,360,13922,13041,13041
13,378,1396,1502,401,40,3717,13042,13042
13,282,1390,829,80,22,2603,13043,13043
13,1863,2278,1462,182,66,5851,13044,13044
13,943,986,870,175,32,3006,13045,13045
13,1067,872,148,51,11,2149,13046,13047
13,46327,33193,26864,7704,3028,117116,13047,13048
13,1404,2804,731,219,22,5180,13048,13049
13,2047,2613,2803,911,127,8501,13049,13050
13,866,1235,1170,426,43,3740,13050,13036
13,2555,2921,3296,414,296,9482,13051,13052
13,690,2522,2364,269,36,5881,13052,13053
13,4851,5436,2963,614,63,13927,13053,13046
13,1384,3786,5286,933,166,11555,13054,13054
13,681,2035,1981,317,74,5088,13055,13055
13,3275,3135,2285,631,195,9521,13056,13056
13,1289,1515,1646,280,95,4825,13057,13057
13,801,1951,2458,343,72,5625,13058,13058
13,3094,3138,3660,710,180,10782,13059,13059
13,504,2394,2583,167,23,5671,13060,13060
13,5353,6317,9617,1587,487,23361,13061,13061
13,1200,4209,2975,180,60,8624,13062,13062
13,7225,7459,9944,1837,607,27072,13063,13063
13,1253,1316,1151,104,51,3875,13064,13064
13,264,1271,2402,166,65,4168,13065,13065
13,2021,5531,6256,570,1655,16033,13066,13067
13,762,1296,1092,420,45,3615,13067,13068
13,6104,6342,8169,1654,746,23015,13068,13069
13,889,2125,2508,345,89,5956,13069,13070
13,343,1557,1447,170,15,3532,13070,13071
13,714,1210,2133,566,73,4696,13071,13072
13,1986,4293,3623,482,90,10474,13072,13073
13,2090,3008,3625,655,167,9545,13073,13074
13,1393,1223,1253,768,90,4727,13074,13075
13,10354,15534,13067,1692,550,41197,13075,13076
13,13443,15916,18259,2624,961,51203,13076,13077
13,1134,903,888,760,73,3758,13077,13066
13,2020,2150,1991,161,31,6353,13078,13078
13,700,1111,831,240,27,2909,13079,13079
13,1758,2674,3114,254,81,7881,13080,13080
13,2171,3048,2571,737,107,8634,13081,13081
13,2343,1975,1697,388,170,6573,13082,13082
13,2693,3497,3870,821,206,11087,13083,13083
13,2428,5122,4639,755,181,13125,13084,13084
14,4509,2350,883,233,128,8103,14001,14001
14,1976,2853,2801,341,583,8554,14002,14002
14,3046,3837,2039,413,143,9478,14003,14003
14,906,1149,234,28,14,2331,14004,14004
14,1653,2274,1256,669,41,5893,14005,14005
14,9802,8171,3853,1197,659,23682,14006,14006
14,1574,1301,688,110,128,3801,14007,14007
14,12920,12011,797,495,192,26415,14008,14008
14,3213,2629,599,336,89,6866,14009,14009
14,1109,983,286,105,6,2489,14010,14010
14,1386,1317,37,43,9,2792,14011,14011
14,1049,892,66,23,12,2042,14012,14012
14,12908,8309,1102,638,202,23159,14013,14013
14,2114,1308,320,54,18,3814,14014,14014
14,11048,7817,1951,1365,263,22444,14015,14015
14,6707,6423,1284,139,81,14634,14016,14016
14,4026,1220,154,100,26,5526,14017,14017
14,8640,9199,5159,1220,142,24360,14018,14018
14,1420,1491,144,20,11,3086,14019,14019
14,1557,2168,867,53,14,4659,14020,14020
14,2363,2687,2153,578,66,7847,14021,14021
14,3804,3902,3237,668,134,11745,14022,14022
14,17825,16703,6537,1294,633,42992,14023,14023
14,1532,2434,1535,675,47,6223,14024,14113
14,4103,2824,4062,556,123,11668,14025,14024
14,3849,2796,719,186,67,7617,14026,14025
14,1441,658,274,25,10,2408,14027,14026
14,3330,2755,596,94,20,6795,14028,14027
14,578,547,19,2,3,1149,14029,14028
14,2292,1913,1599,1178,106,7088,14030,14029
14,6596,6618,3636,1227,416,18493,14031,14030
14,487,748,53,9,8,1305,14032,14031
14,940,906,272,119,12,2249,14033,14032
14,4449,3892,344,92,25,8802,14034,14033
14,566,486,20,8,4,1084,14035,14034
14,10262,6927,825,604,144,18762,14036,14035
14,3549,2852,999,371,103,7874,14037,14036
14,2376,2667,492,150,55,5740,14038,14079
14,3733,3723,728,469,115,8768,14039,14037
14,751,990,142,19,8,1910,14040,14038
14,395691,240567,103448,52271,20380,812357,14041,14039
14,1531,1618,347,35,20,3551,14042,14040
14,1317,968,596,36,28,2945,14043,14041
14,1715,1147,558,18,12,3450,14044,14042
14,2868,3472,2071,286,171,8868,14045,14043
14,4329,3522,1013,1000,106,9970,14046,14044
14,2647,2992,1246,296,195,7376,14047,14045
14,6914,3346,393,266,115,11034,14048,14046
14,3870,3033,1216,950,56,9125,14049,14047
14,4944,2438,346,121,76,7925,14050,14048
14,1561,1453,623,10,9,3656,14051,14049
14,6624,4045,2584,1161,584,14998,14052,14050
14,2097,1966,1123,197,96,5479,14053,14051
14,1344,720,625,104,10,2803,14054,14052
14,30937,16143,4009,1548,695,53332,14055,14053
14,899,984,693,225,33,2834,14056,14054
14,3360,3553,674,79,45,7711,14057,14055
14,611,329,246,4,5,1195,14058,14056
14,804,418,669,32,10,1933,14059,14057
14,2668,2265,766,284,98,6081,14060,14058
14,1992,1988,1530,179,141,5830,14061,14059
14,1588,880,207,42,11,2728,14062,14060
14,2502,1845,1052,63,29,5491,14063,14061
14,804,724,166,31,10,1735,14064,14062
14,19194,11836,4278,1528,402,37238,14065,14063
14,3156,2535,3296,389,345,9721,14066,14064
14,1852,2257,1226,92,91,5518,14067,14065
14,5580,4632,4753,612,264,15841,14068,14066
14,30196,24737,14969,3241,1367,74510,14069,14067
14,2071,1807,401,153,16,4448,14070,14068
14,981,1557,1321,39,30,3928,14071,14069
14,11537,15444,6592,3018,753,37344,14072,14070
14,640,647,65,69,8,1429,14073,14071
14,1599,1024,168,35,24,2850,14074,14072
14,16544,5491,935,695,199,23864,14075,14073
14,4764,1968,126,81,48,6987,14076,14074
14,517,673,387,93,17,1687,14077,14075
14,582,600,24,8,1,1215,14078,14076
14,3845,3270,3849,658,110,11732,14079,14077
14,7260,3672,540,299,179,11950,14080,14078
14,308,929,1311,25,14,2587,14081,14080
14,925,481,347,25,20,1798,14082,14081
14,3983,4639,2495,793,1216,13126,14083,14082
14,7114,7299,5153,1726,827,22119,14084,14083
14,2386,2930,701,134,42,6193,14085,14084
14,6665,7997,2105,112,79,16958,14086,14085
14,2366,2917,1836,126,78,7323,14087,14086
14,2920,2872,1790,54,43,7679,14088,14087
14,3231,2647,732,441,56,7107,14089,14088
14,662,563,400,13,24,1662,14090,14089
14,1946,1100,220,159,15,3440,14091,14090
14,6102,4580,2365,983,169,14199,14092,14091
14,2239,2448,352,108,36,5183,14093,14092
14,31833,14476,2816,2477,731,52333,14094,14093
14,8010,3580,2448,257,108,14403,14095,14094
14,1151,1752,1385,48,23,4359,14096,14095
14,3209,2055,1589,139,132,7124,14097,14096
14,28020,17457,9544,3633,1107,59761,14098,14097
14,92553,65874,23095,12620,4689,198831,14099,14098
14,1388,1805,416,59,18,3686,14100,14099
14,2974,3788,3147,883,318,11110,14101,14100
14,51460,45557,14217,8475,3187,122896,14102,14101
14,1705,1176,108,18,15,3022,14103,14102
14,1485,1249,664,179,13,3590,14104,14103
14,1160,689,526,13,17,2405,14105,14104
14,4507,3456,464,270,47,8744,14106,14105
14,920,970,181,30,38,2139,14107,14106
14,1334,686,603,116,47,2786,14108,14107
14,3360,7527,2739,870,247,14743,14109,14108
14,3292,2773,412,74,75,6626,14110,14109
14,2323,2006,831,517,88,5765,14111,14110
14,1787,974,71,130,21,2983,14112,14111
14,1177,904,510,28,16,2635,14113,14112
14,2266,2383,1515,501,667,7332,14114,14114
14,1103,1072,474,23,20,2692,14115,14115
14,3779,2271,380,161,102,6693,14116,14116
14,1020,727,48,26,5,1826,14117,14117
14,5900,3506,566,194,96,10262,14118,14118
14,4295,3401,2895,524,454,11569,14119,14119
14,233340,143992,47874,24289,11315,460810,14120,14120
14,4575,4745,2201,422,178,12121,14121,14121
14,752,1332,480,15,7,2586,14122,14122
14,2986,2654,724,89,46,6499,14123,14123
14,12035,8030,2080,499,319,22963,14124,14124
14,3622,1599,218,97,947,6483,14125,14125
15,4977,8786,3902,1106,213,18984,15001,15001
15,5466,8943,12684,1409,655,29157,15002,15002
15,4595,4844,3890,582,217,14128,15003,15003
15,1400,1945,1441,109,48,4943,15004,15004
15,14195,13889,11359,1706,771,41920,15005,15005
15,915,1543,1016,371,53,3898,15006,15006
15,962,2826,2838,150,72,6848,15007,15007
15,1361,5296,3732,102,46,10537,15008,15008
15,4685,4300,7739,1563,861,19148,15009,15009
15,4268,1609,2831,539,250,9497,15010,15010
15,2405,2679,7700,1657,496,14937,15011,15011
15,943,1090,763,312,49,3157,15012,15012
15,91237,38505,63429,11524,8251,212946,15013,15013
15,7380,13929,6499,1887,555,30250,15014,15014
15,2139,2164,4086,318,205,8912,15015,15015
15,2575,2300,3393,284,92,8644,15016,15016
15,527,888,995,151,59,2620,15017,15017
15,4670,3435,4208,745,267,13325,15018,15018
15,1705,2337,3104,709,195,8050,15019,15019
15,35670,29803,42284,8268,5909,121934,15020,15020
15,3090,3069,2130,179,122,8590,15021,15021
15,1316,1235,2153,375,185,5264,15022,15022
15,3315,4126,5813,1228,574,15056,15023,15023
15,10702,8165,9592,2702,1188,32349,15024,15024
15,85797,39260,67007,16367,10046,218477,15025,15121
15,15873,18510,37255,5823,3700,81161,15026,15025
15,3772,3450,1408,242,79,8951,15027,15026
15,905,967,612,87,34,2605,15028,15027
15,1801,2347,4289,479,243,9159,15029,15028
15,5757,8555,22035,2734,1617,40698,15030,15029
15,2030,1328,4389,410,358,8515,15031,15030
15,24637,51205,68930,8742,4787,158301,15032,15031
15,1096,3487,5255,326,51,10215,15033,15032
15,164183,131530,312782,44370,26353,679218,15034,15033
15,862,853,900,75,31,2721,15035,15034
15,6245,6797,5628,1093,553,20316,15036,15035
15,1797,5831,5752,524,196,14100,15037,15036
15,35184,23779,25031,4454,2783,91231,15038,15037
15,598,1156,1178,121,80,3133,15039,15038
15,22980,28092,61636,8329,5244,126281,15040,15039
15,2615,6035,1440,267,153,10510,15041,15040
15,482,909,1084,36,5,2516,15042,15041
15,9228,19986,12734,2640,898,45486,15043,15042
15,1063,1894,1933,619,85,5594,15044,15043
15,2249,2260,4445,752,377,10083,15045,15044
15,7587,11363,10143,1290,470,30853,15046,15045
15,1674,1820,2485,254,175,6408,15047,15046
15,2857,8080,8853,995,373,21158,15048,15047
15,5151,11750,4294,943,280,22418,15049,15048
15,1039,1469,1175,267,52,4002,15050,15049
15,1804,2076,3514,366,186,7946,15051,15050
15,14440,11216,15493,2166,1118,44433,15052,15051
15,2114,2820,2249,462,132,7777,15053,15052
15,4132,4277,7636,1037,366,17448,15054,15053
15,42522,19874,21853,5281,2603,92133,15055,15054
15,1188,842,1060,131,61,3282,15056,15055
15,1915,3613,2420,441,107,8496,15057,15056
15,156088,80608,121767,19651,14664,392778,15058,15057
15,1852,1777,2766,516,221,7132,15059,15059
15,112479,93831,278561,33078,21366,539315,15060,15058
15,35381,29820,35944,9247,3530,113922,15061,15060
15,1150,1172,1126,59,40,3547,15062,15061
15,5559,6095,7682,1260,647,21243,15063,15062
15,842,2812,3939,303,58,7954,15064,15063
15,3683,4031,3332,536,178,11760,15065,15064
15,2420,3068,5223,344,202,11257,15066,15065
15,540,551,770,12,10,1883,15067,15066
15,7572,5365,8004,1048,483,22472,15068,15067
15,1650,2246,3636,428,238,8198,15069,15068
15,667,477,599,95,56,1894,15070,15069
15,12853,22449,40273,4122,2993,82690,15071,15070
15,1739,2762,1000,226,103,5830,15072,15071
15,1254,1258,934,250,97,3793,15073,15072
15,1986,1254,807,163,54,4264,15074,15073
15,6546,13366,10980,1271,372,32535,15075,15074
15,3190,1714,2872,307,139,8222,15076,15075
15,9146,6330,7837,1823,757,25893,15077,15076
15,303,1026,699,31,13,2072,15078,15077
15,727,782,1444,58,21,3032,15079,15078
15,2279,1659,607,174,44,4763,15080,15079
15,2766,4044,1805,113,44,8772,15081,15080
15,30519,24323,26569,5105,3115,89631,15082,15081
15,5131,10435,6881,382,208,23037,15083,15082
15,967,1202,1283,223,128,3803,15084,15083
15,4178,2882,4075,482,228,11845,15085,15084
15,3355,7126,8817,1301,247,20846,15086,15085
15,3900,4052,1501,211,101,9765,15087,15086
15,6291,7234,8576,850,487,23438,15088,15087
15,7271,6112,8604,2325,648,24960,15089,15088
15,728,1497,1443,205,127,4000,15090,15089
15,5528,5553,7225,1590,474,20370,15091,15090
15,7587,5650,10657,3082,743,27719,15092,15091
15,3812,6816,8105,949,453,20135,15093,15092
15,1925,2777,3886,454,259,9301,15094,15093
15,1077,1494,2726,213,116,5626,15095,15094
15,8390,8374,7949,1751,925,27389,15096,15095
15,4184,2791,3641,546,277,11439,15097,15096
15,979,2113,1930,118,64,5204,15098,15097
15,267,655,691,172,21,1806,15099,15098
15,15050,21642,39442,4698,2801,83633,15100,15099
15,1865,1817,5015,595,325,9617,15101,15100
15,6094,9476,4813,2465,411,23259,15102,15101
15,2273,2412,1127,199,59,6070,15103,15102
15,3450,3981,8369,1201,635,17636,15104,15103
15,137540,57546,115005,23274,12202,345567,15105,15104
15,1020,4255,6564,185,47,12071,15106,15105
15,150289,81002,54095,16808,8856,311050,15107,15106
15,970,2423,1191,88,47,4719,15108,15107
15,9177,8885,18875,2718,1765,41420,15109,15108
15,41819,37225,69398,14241,7685,170368,15110,15109
15,6368,7533,6017,1820,576,22314,15111,15110
15,4563,3985,3237,389,119,12293,15112,15111
15,4747,6100,2319,383,178,13727,15113,15112
15,4577,5998,3665,464,219,14923,15114,15113
15,4479,9346,7297,738,220,22080,15115,15114
15,5379,4194,6516,744,493,17326,15116,15115
15,656,531,262,15,5,1469,15117,15116
15,1051,1924,1456,53,56,4540,15118,15117
15,20225,13248,10185,2541,1345,47544,15119,15118
15,1418,1744,1146,97,25,4430,15120,15119
15,8412,17495,12513,2989,1011,42420,15121,15120
15,17169,26933,59127,7258,4743,115230,15122,15122
15,3032,3758,2291,65,58,9204,15123,15123
15,7663,8637,4284,459,160,21203,15124,15124
15,416,859,1102,121,92,2590,15125,15125
16,1067,836,1294,48,51,3296,16001,16001
16,730,966,3500,30,27,5253,16002,16002
16,2243,1838,2580,157,93,6911,16003,16003
16,719,1894,2453,54,41,5161,16004,16004
16,811,1565,1350,105,49,3880,16005,16005
16,7452,8988,18485,975,748,36648,16006,16006
16,247,504,510,15,10,1286,16007,16007
16,1222,2578,2634,48,41,6523,16008,16008
16,3519,2821,3343,273,190,10146,16009,16009
16,883,2438,3500,63,51,6935,16010,16010
16,911,928,1379,79,42,3339,16011,16011
16,1997,3042,6212,208,132,11591,16012,16012
16,259,1679,1163,12,7,3120,16013,16013
16,939,1147,1831,99,55,4071,16014,16014
16,2086,1823,2314,55,43,6321,16015,16015
16,1337,2373,4252,121,88,8171,16016,16016
16,1748,1900,5589,204,71,9512,16017,16017
16,471,920,1028,38,35,2492,16018,16018
16,3857,1507,2185,110,56,7715,16019,16019
16,2742,1435,2772,367,177,7493,16020,16020
16,762,1501,1556,27,19,3865,16021,16021
16,3071,1284,1928,125,107,6515,16022,16022
16,1171,1326,1149,67,40,3753,16023,16023
16,588,1350,2863,84,55,4940,16024,16024
16,1932,3517,4449,223,135,10256,16025,16025
16,199,766,851,5,3,1824,16026,16026
16,391,534,934,48,18,1925,16027,16027
16,523,490,1527,42,41,2623,16028,16028
16,184,1233,2692,15,7,4131,16029,16029
16,644,2993,1497,37,23,5194,16030,16030
16,1255,1835,2494,97,73,5754,16031,16031
16,998,1247,2478,174,102,4999,16032,16032
16,710,1742,4267,118,56,6893,16033,16033
16,17063,7688,11109,934,535,37329,16034,16034
16,1450,3703,5483,151,60,10847,16035,16035
16,1583,1184,1554,107,72,4500,16036,16036
16,382,419,2063,53,28,2945,16037,16037
16,899,4894,6391,180,87,12451,16038,16038
16,297,633,1298,73,37,2338,16039,16039
16,1343,1392,1941,90,68,4834,16040,16040
16,1360,1090,1801,110,70,4431,16041,16041
16,1099,1420,2424,64,49,5056,16042,16042
16,7146,4658,5313,324,244,17685,16043,16043
16,1156,1270,2210,86,72,4794,16044,16044
16,3939,2817,6844,312,175,14087,16045,16045
16,2725,2606,4758,125,60,10274,16046,16113
16,589,1689,2217,55,39,4589,16047,16046
16,628,2265,3476,67,43,6479,16048,16047
16,439,587,905,51,27,2009,16049,16048
16,9192,10301,34039,2746,1497,57775,16050,16052
16,991,1307,2457,58,47,4860,16051,16049
16,6127,4415,11762,1012,329,23645,16052,16050
16,2040,949,1609,102,70,4770,16053,16051
16,116788,49583,85890,12823,8492,273576,16054,16053
16,1134,740,962,40,30,2906,16055,16054
16,1473,3785,7277,436,145,13116,16056,16055
16,1106,3438,4284,101,70,8999,16057,16056
16,136,1395,1363,13,11,2918,16058,16057
16,890,2997,2169,118,51,6225,16059,16058
16,305,567,1808,38,21,2739,16060,16059
16,885,1074,1532,59,23,3573,16061,16060
16,982,1756,3261,208,52,6259,16062,16061
16,2901,1203,2242,93,44,6483,16063,16062
16,954,1650,2317,56,57,5034,16064,16063
16,801,1271,4674,80,51,6877,16065,16064
16,1666,2859,5742,474,198,10939,16066,16065
16,7418,6723,11374,1032,687,27234,16067,16066
16,1220,2387,2276,58,55,5996,16068,16067
16,4055,1833,2319,239,135,8581,16069,16068
16,18248,8042,6988,1044,417,34739,16070,16069
16,2471,1358,1944,160,91,6024,16071,16070
16,7366,3850,11773,509,322,23820,16072,16071
16,1313,984,1905,137,77,4416,16073,16072
16,4037,1747,2504,235,125,8648,16074,16073
16,836,708,1928,259,25,3756,16075,16074
16,7287,6189,7868,649,390,22383,16076,16075
16,14170,4891,6368,502,224,26155,16077,16076
16,671,1861,3394,47,24,5997,16078,16077
16,1637,1098,1406,137,62,4340,16079,16078
16,2673,2763,6519,320,191,12466,16080,16079
16,1284,1369,2565,113,80,5411,16081,16080
16,191,1350,1584,10,9,3144,16082,16081
16,6485,5754,6331,1700,341,20611,16083,16082
16,2140,1868,4015,78,98,8199,16084,16083
16,2075,2428,3408,106,86,8103,16085,16084
16,4166,2381,2621,206,173,9547,16086,16085
16,1279,721,3340,53,47,5440,16087,16086
16,1046,1694,2186,182,52,5160,16088,16087
16,4686,3675,5463,494,220,14538,16089,16088
16,1679,2093,3297,132,90,7291,16090,16089
16,875,1118,2339,201,69,4602,16091,16090
16,2511,1475,1386,88,73,5533,16092,16091
16,336,1861,2111,23,20,4351,16093,16092
16,2833,1359,3622,648,161,8623,16094,16093
16,499,875,1750,33,34,3191,16095,16094
16,1624,1196,1721,100,61,4702,16096,16095
16,122,937,1894,11,9,2973,16097,16096
16,929,3289,5028,150,107,9503,16098,16097
16,2168,2685,2947,186,129,8115,16099,16098
16,592,1941,3373,53,18,5977,16100,16099
16,1145,881,1963,87,74,4150,16101,16100
16,711,1188,989,25,13,2926,16102,16101
16,36371,17535,37982,5098,2780,99766,16103,16102
16,2315,1684,3773,486,48,8306,16104,16103
16,2145,1640,2349,103,56,6293,16105,16104
16,1415,1835,3232,85,45,6612,16106,16105
16,2683,2102,4281,141,78,9285,16107,16106
16,6848,8648,10413,926,451,27286,16108,16107
16,29440,12058,18963,1884,1262,63607,16109,16108
16,337,571,596,11,15,1530,16110,16109
16,5168,3784,6936,424,267,16579,16111,16110
16,1006,1370,2396,206,70,5048,16112,16111
16,12033,18627,15300,2011,738,48709,16113,16112
17,1383,2001,2662,537,110,6693,17001,17001
17,2440,1209,1902,626,552,6729,17002,17002
17,3247,4648,2506,415,554,11370,17003,17003
17,8934,6442,7145,2788,590,25899,17004,17004
17,1093,1575,1125,469,37,4299,17005,17005
17,18287,16942,21281,6839,1951,65300,17006,17006
17,72014,30166,52957,10583,6762,172482,17007,17007
17,7794,6788,6583,1083,300,22548,17008,17008
17,1953,1318,3535,205,140,7151,17009,17009
17,2051,1551,1853,292,102,5849,17010,17010
17,29319,11614,30316,3426,1486,76161,17011,17011
17,5989,6608,8431,1743,459,23230,17012,17012
17,2655,1593,1145,398,342,6133,17013,17013
17,873,1932,1117,220,38,4180,17014,17014
17,1798,4597,3137,161,79,9772,17015,17015
17,2346,984,1897,378,637,6242,17016,17016
17,6018,7416,6572,1876,443,22325,17017,17017
17,12234,8252,12065,1866,814,35231,17018,17018
17,3372,3061,2491,803,141,9868,17019,17019
17,4130,2732,6104,780,396,14142,17020,17020
17,888,1400,771,314,46,3419,17021,17021
17,1926,1173,1658,1580,156,6493,17022,17022
17,300,750,1658,64,22,2794,17023,17023
17,4794,4615,6670,1494,544,18117,17024,17024
17,2734,5027,3326,453,323,11863,17025,17025
17,1449,1794,2579,1134,213,7169,17026,17026
17,1533,1103,1055,337,51,4079,17027,17027
17,7003,4995,6279,635,360,19272,17028,17028
17,11761,7836,11556,2729,845,34727,17029,17029
17,4244,4173,4151,1142,605,14315,17030,17030
17,3434,5340,5750,813,562,15899,17031,17031
17,1321,989,992,464,37,3803,17032,17032
17,1455,1549,1801,470,93,5368,17033,17033
18,2917,5323,4669,680,102,13691,18001,18001
18,1441,2474,1776,244,60,5995,18002,18002
18,2077,1721,813,62,41,4714,18003,18003
18,6011,7835,6068,768,310,20992,18004,18020
18,5460,8735,8777,771,262,24005,18005,18004
18,211,1737,1480,58,14,3500,18006,18005
18,2886,3288,3053,479,113,9819,18007,18006
18,1974,2896,1313,153,58,6394,18008,18007
18,1027,3239,1819,29,58,6172,18009,18009
18,1311,5974,5543,434,89,13351,18010,18010
18,1674,3068,3363,147,61,8313,18011,18011
18,4805,4471,4139,234,142,13791,18012,18012
18,1055,1300,565,93,25,3038,18013,18013
18,794,4689,2328,129,61,8001,18014,18014
18,2800,16762,15547,736,184,36029,18015,18015
18,3574,5686,6500,433,110,16303,18016,18016
18,21088,41285,55548,8939,3032,129892,18017,18017
18,1825,4505,5133,463,98,12024,18018,18018
18,1555,6493,5207,800,281,14336,18019,18008
18,838,1476,257,15,18,2604,18020,18019
19,522,767,56,95,8,1448,19001,19001
19,1206,1370,47,17,4,2644,19002,19002
19,837,625,30,10,1,1503,19003,19003
19,3810,5272,1850,502,137,11571,19004,19004
19,2767,3672,554,132,31,7156,19005,19005
19,42192,54344,9857,10119,1515,118027,19006,19006
19,638,4268,256,1636,54,6852,19007,19007
19,1054,606,242,43,7,1952,19008,19008
19,11190,12677,4035,1927,403,30232,19009,19009
19,871,1397,136,839,14,3257,19010,19010
19,1487,2261,110,104,19,3981,19011,19011
19,1700,1881,950,235,35,4801,19012,19012
19,1654,2778,992,215,31,5670,19013,19013
19,2530,6369,3236,746,162,13043,19014,19014
19,1004,898,89,25,5,2021,19015,19015
19,630,461,262,139,6,1498,19016,19016
19,1619,6804,1494,1118,3849,14884,19017,19017
19,3497,5548,3987,1477,130,14639,19018,19018
19,40352,19300,2409,3441,631,66133,19019,19019
19,950,1564,269,588,17,3388,19020,19020
19,30236,38542,8226,5840,1089,83933,19021,19021
19,3384,2757,239,158,29,6567,19022,19022
19,642,497,40,20,7,1206,19023,19023
19,468,1507,277,42,7,2301,19024,19024
19,2041,1315,112,94,9,3571,19025,19025
19,123558,112802,28856,21482,4147,290845,19026,19026
19,764,1037,80,94,3,1978,19027,19027
19,1693,3359,952,569,27,6600,19028,19047
19,193,413,250,23,1,880,19029,19028
19,1733,1419,128,124,11,3415,19030,19029
19,278,964,549,96,12,1899,19031,19030
19,11195,12327,3803,2266,337,29928,19032,19031
19,604,1078,169,666,14,2531,19033,19032
19,15330,11059,1444,2455,178,30466,19034,19033
19,923,980,258,97,6,2264,19035,19034
19,264,388,21,221,2,896,19036,19035
19,369,1857,125,103,17,2471,19037,19036
19,445,1223,542,203,7,2420,19038,19037
19,8355,7441,3393,1119,1883,22191,19039,19038
19,222744,201031,52572,36787,6613,519747,19040,19039
19,211,460,503,10,2,1186,19041,19040
19,2247,2507,538,275,70,5637,19042,19041
19,1447,1051,64,34,4,2600,19043,19042
19,330,954,120,17,17,1438,19044,19043
19,7888,4452,2733,569,88,15730,19045,19044
19,2177,4693,569,812,51,8302,19046,19045
19,137908,54970,18383,17801,2859,231921,19047,19046
19,41893,29101,7223,14998,1126,94341,19048,19048
19,7845,7457,1397,1147,166,18012,19049,19049
19,171,795,518,9,3,1496,19050,19050
19,492,853,702,57,21,2125,19051,19051
20,35,186,113,0,5,339,20001,20001
20,3705,6170,7084,285,327,17571,20002,20002
20,320,468,547,51,41,1427,20003,20174
20,63,264,228,9,8,572,20004,20003
20,212,187,36,3,3,441,20005,20004
20,364,2996,3815,34,37,7246,20006,20005
20,683,2531,2660,83,77,6034,20007,20006
20,470,325,225,9,11,1040,20008,20007
20,26,195,187,1,2,411,20009,20008
20,453,288,592,58,24,1415,20010,20398
20,107,1050,813,12,7,1989,20011,20009
20,1429,1905,2047,75,63,5519,20012,20010
20,36,102,211,4,3,356,20013,20011
20,239,879,1368,18,26,2530,20014,20012
20,873,1458,1379,16,14,3740,20015,20025
20,243,1145,1373,30,25,2816,20016,20026
20,172,406,600,18,29,1225,20017,20013
20,274,690,177,13,10,1164,20018,20015
20,69,245,765,19,17,1115,20019,20016
20,157,905,214,9,9,1294,20020,20017
20,71,76,108,7,3,265,20021,20018
20,82,453,351,11,8,905,20022,20019
20,38,157,138,15,4,352,20023,20020
20,1175,1950,2372,133,122,5752,20024,20021
20,39,185,177,6,8,415,20025,20022
20,937,1744,2281,137,116,5215,20026,20023
20,152,381,311,21,11,876,20027,20024
20,3376,2677,1480,171,83,7787,20028,20028
20,142,265,349,4,4,764,20029,20029
20,144,2422,1661,30,22,4279,20030,20030
20,11,199,141,0,1,352,20031,20032
20,56,247,273,2,1,579,20032,20034
20,160,172,511,36,24,903,20033,20033
20,18,52,148,1,4,223,20034,20035
20,135,944,679,3,4,1765,20035,20036
20,103,312,468,7,9,899,20036,20037
20,8761,5599,7888,581,637,23466,20037,20039
20,46,1246,547,3,9,1851,20038,20040
20,2033,5204,4167,75,94,11573,20039,20041
20,34,207,235,2,7,485,20040,20065
20,1558,4722,5210,201,126,11817,20041,20014
20,593,830,1359,46,62,2890,20042,20042
20,1333,15790,19942,245,152,37462,20043,20043
20,3106,4474,6348,363,199,14490,20044,20044
20,513,358,917,66,50,1904,20045,20045
20,237,425,435,18,21,1136,20046,20046
20,9,169,107,0,1,286,20047,20048
20,33,225,195,0,8,461,20048,20049
20,94,149,512,14,19,788,20049,20050
20,84,129,143,4,4,364,20050,20051
20,145,857,1520,101,20,2643,20051,20052
20,5,336,255,0,5,601,20052,20053
20,85,156,173,4,5,423,20053,20562
20,27,54,58,3,4,146,20054,20054
20,77,659,559,8,9,1312,20055,20055
20,23,258,278,21,4,584,20056,20056
20,4965,6060,4060,278,105,15468,20057,20057
20,249,1616,1519,20,50,3454,20058,20058
20,4207,3614,3972,210,194,12197,20059,20059
20,39,455,142,3,2,641,20060,20060
20,149,349,131,17,9,655,20061,20061
20,39,94,70,5,5,213,20062,20062
20,173,409,1049,43,32,1706,20063,20063
20,491,1053,876,23,32,2475,20064,20064
20,107,130,96,3,3,339,20065,20504
20,33345,28346,61090,5481,4317,132579,20066,20067
20,1985,1619,3331,262,274,7471,20067,20068
20,153,334,78,6,4,575,20068,20069
20,63,1461,1030,33,11,2598,20069,20070
20,128,531,560,11,7,1237,20070,20071
20,758,3222,5496,160,112,9748,20071,20073
20,98,575,518,11,6,1208,20072,20075
20,65,334,418,7,9,833,20073,20076
20,241,254,671,26,23,1215,20074,20077
20,97,96,156,17,8,374,20075,20078
20,4857,9623,16098,566,290,31434,20076,20079
20,143,300,359,3,6,811,20077,20080
20,27,302,337,5,8,679,20078,20081
20,44,547,690,13,13,1307,20079,20082
20,581,587,856,94,62,2180,20080,20083
20,325,287,869,57,51,1589,20081,20084
20,363,3180,2662,53,48,6306,20082,20085
20,30,45,194,5,7,281,20083,20086
20,308,268,188,34,27,825,20084,20087
20,88,560,189,1,2,840,20085,20088
20,56,334,282,14,7,693,20086,20089
20,155,713,1025,80,26,1999,20087,20090
20,434,293,605,75,76,1483,20088,20091
20,121,113,229,17,14,494,20089,20092
20,17,106,104,2,2,231,20090,20093
20,77,474,140,5,5,701,20091,20094
20,216,479,186,8,10,899,20092,20095
20,55,98,115,2,10,280,20093,20096
20,86,85,283,7,5,466,20094,20097
20,231,521,394,3,7,1156,20095,20098
20,13,121,13,1,1,149,20096,20099
20,26,22,151,2,2,203,20097,20100
20,15,155,34,6,3,213,20098,20101
20,193,552,816,23,24,1608,20099,20102
20,304,476,948,37,34,1799,20100,20103
20,123,351,203,17,10,704,20101,20104
20,62,1705,228,11,12,2018,20102,20105
20,37,58,61,0,3,159,20103,20106
20,1592,1130,2450,242,179,5593,20104,20107
20,227,200,1075,16,20,1538,20105,20108
20,49,256,259,11,3,578,20106,20109
20,20,242,83,4,1,350,20107,20110
20,31,140,696,7,3,877,20108,20111
20,228,470,518,11,5,1232,20109,20112
20,138,234,404,7,8,791,20110,20113
20,30,31,227,4,4,296,20111,20114
20,653,435,1282,92,75,2537,20112,20115
20,53,85,162,24,9,333,20113,20121
20,59,192,96,7,7,361,20114,20122
20,341,498,671,2,2,1514,20115,20116
20,93,144,354,4,9,604,20116,20117
20,95,244,67,3,5,414,20117,20118
20,9,61,61,0,2,133,20118,20119
20,20,33,105,3,1,162,20119,20120
20,66,407,248,13,10,744,20120,20123
20,132,4998,3091,37,19,8277,20121,20124
20,585,1145,1237,18,31,3016,20122,20125
20,198,299,677,13,20,1207,20123,20126
20,19,59,201,1,2,282,20124,20127
20,115,120,207,6,11,459,20125,20128
20,24,37,67,3,2,133,20126,20129
20,22,1293,853,2,3,2173,20127,20130
20,577,1128,768,37,31,2541,20128,20131
20,143,146,136,8,9,442,20129,20132
20,52,180,863,6,14,1115,20130,20133
20,805,4776,4787,16,30,10414,20131,20134
20,353,462,615,55,42,1527,20132,20135
20,983,1968,1520,3,11,4485,20133,20136
20,175,205,372,4,6,762,20134,20137
20,30,9,146,8,7,200,20135,20138
20,13,263,119,2,3,400,20136,20139
20,9,147,99,1,3,259,20137,20140
20,56,1233,986,5,7,2287,20138,20141
20,60,62,275,5,3,405,20139,20142
20,211,1796,1764,10,11,3792,20140,20143
20,49,136,203,3,7,398,20141,20144
20,142,168,246,20,24,600,20142,20145
20,188,208,154,10,19,579,20143,20146
20,11,82,47,1,1,142,20144,20147
20,50,89,289,4,6,438,20145,20148
20,95,152,119,4,6,376,20146,20149
20,459,1721,2050,125,81,4436,20147,20150
20,20,70,64,1,1,156,20148,20151
20,47,126,215,5,4,397,20149,20152
20,87,854,534,9,5,1489,20150,20153
20,121,533,48,4,3,709,20151,20154
20,29,151,18,3,6,207,20152,20155
20,302,405,679,8,26,1420,20153,20156
20,798,981,2109,142,129,4159,20154,20157
20,53,119,422,6,7,607,20155,20158
20,295,546,357,20,18,1236,20156,20159
20,135,211,91,4,0,441,20157,20160
20,199,470,312,21,20,1022,20158,20161
20,53,256,90,6,2,407,20159,20162
20,40,281,226,13,8,568,20160,20163
20,333,671,776,55,47,1882,20161,20550
20,44,163,340,6,6,559,20162,20164
20,28,199,212,7,4,450,20163,20165
20,1355,1245,1932,73,43,4648,20164,20166
20,39,497,30,1,2,569,20165,20167
20,74,133,128,2,2,339,20166,20168
20,52,857,913,7,9,1838,20167,20169
20,164,662,292,12,25,1155,20168,20170
20,540,724,433,36,31,1764,20169,20072
20,484,2475,3291,14,21,6285,20170,20171
20,16,58,148,5,2,229,20171,20172
20,54,203,285,8,9,559,20172,20173
20,142,185,224,7,9,567,20173,20175
20,163,265,465,35,8,936,20174,20176
20,604,1490,1650,48,33,3825,20175,20177
20,378,323,704,58,45,1508,20176,20178
20,61,204,144,9,7,425,20177,20179
20,155,380,409,10,7,961,20178,20180
20,99,128,14,2,3,246,20179,20181
20,121,133,96,6,4,360,20180,20183
20,17,407,302,2,4,732,20181,20182
20,18291,16389,20374,1234,872,57160,20182,20184
20,1081,2718,4430,60,48,8337,20183,20559
20,164,1198,1451,98,37,2948,20184,20185
20,17,71,63,2,3,156,20185,20191
20,147,188,295,22,13,665,20186,20192
20,57,480,235,7,5,784,20187,20027
20,39,118,50,1,0,208,20188,20186
20,14,486,302,0,1,803,20189,20187
20,62,1491,1533,13,21,3120,20190,20188
20,94,431,147,1,0,673,20191,20189
20,879,2636,2279,90,56,5940,20192,20190
20,201,254,455,12,6,928,20193,20206
20,372,176,228,27,20,823,20194,20193
20,155,179,105,7,7,453,20195,20194
20,96,112,189,1,5,403,20196,20195
20,9,78,138,1,2,228,20197,20196
20,162,325,212,10,22,731,20198,20197
20,421,6020,6528,66,53,13088,20199,20198
20,120,131,11,2,0,264,20200,20199
20,241,284,393,19,11,948,20201,20200
20,18,187,386,4,0,595,20202,20201
20,151,762,340,9,11,1273,20203,20202
20,186,358,271,8,15,838,20204,20203
20,23,100,192,2,2,319,20205,20204
20,503,3055,2403,8,32,6001,20206,20205
20,601,2382,1279,50,46,4358,20207,20207
20,116,868,1496,38,23,2541,20208,20208
20,48,122,75,7,5,257,20209,20209
20,83,1300,539,11,8,1941,20210,20210
20,65,124,368,5,4,566,20211,20211
20,45,98,283,2,6,434,20212,20212
20,214,155,462,17,13,861,20213,20213
20,95,98,382,11,8,594,20214,20214
20,45,95,109,4,8,261,20215,20215
20,25,71,201,3,2,302,20216,20216
20,63,438,369,11,11,892,20217,20217
20,3,160,38,0,0,201,20218,20218
20,247,307,123,11,5,693,20219,20219
20,105,264,427,5,13,814,20220,20220
20,59,77,254,5,5,400,20221,20221
20,49,128,218,2,2,399,20222,20222
20,18,101,90,1,0,210,20223,20223
20,50,99,188,2,5,344,20224,20224
20,607,548,819,1,16,1991,20225,20225
20,153,291,171,10,15,640,20226,20226
20,832,655,2149,174,121,3931,20227,20227
20,17,164,121,1,0,303,20228,20228
20,252,228,380,6,4,870,20229,20229
20,29,159,136,2,3,329,20230,20230
20,112,112,41,2,1,268,20231,20231
20,1979,3018,2703,32,42,7774,20232,20232
20,83,186,28,4,5,306,20233,20233
20,122,1099,917,27,12,2177,20234,20234
20,195,778,297,7,10,1287,20235,20235
20,182,45,185,4,2,418,20236,20236
20,52,160,283,7,5,507,20237,20237
20,12,194,153,0,3,362,20238,20238
20,38,74,259,7,8,386,20239,20239
20,11,128,423,4,5,571,20240,20240
20,116,206,71,6,4,403,20241,20241
20,280,370,1083,35,21,1789,20242,20242
20,165,239,181,11,16,612,20243,20243
20,127,419,501,17,13,1077,20244,20244
20,18,301,241,1,0,561,20245,20245
20,23,94,90,2,1,210,20246,20246
20,403,2193,1301,28,35,3960,20247,20248
20,56,131,143,2,3,335,20248,20250
20,95,84,45,7,4,235,20249,20251
20,42,140,254,9,9,454,20250,20252
20,60,327,392,3,7,789,20251,20253
20,484,399,215,4,14,1116,20252,20254
20,55,108,130,5,4,302,20253,20255
20,31,28,48,0,2,109,20254,20256
20,154,527,337,9,13,1040,20255,20249
20,18,115,196,4,5,338,20256,20257
20,25,166,82,4,3,280,20257,20258
20,337,333,36,0,1,707,20258,20259
20,87,450,245,4,7,793,20259,20260
20,453,1276,384,8,15,2136,20260,20261
20,45,170,94,9,11,329,20261,20262
20,52,145,477,14,6,694,20262,20264
20,97,1368,1039,12,9,2525,20263,20265
20,265,234,202,8,10,719,20264,20263
20,242,1124,1197,14,15,2592,20265,20266
20,9,45,42,2,0,98,20266,20267
20,87,208,44,2,3,344,20267,20268
20,48,223,977,9,14,1271,20268,20269
20,22,185,211,4,1,423,20269,20270
20,99,140,432,27,6,704,20270,20271
20,62,457,861,11,12,1403,20271,20272
20,216,621,202,14,8,1061,20272,20273
20,84,159,126,3,6,378,20273,20274
20,72,622,434,11,4,1143,20274,20275
20,22,88,71,3,4,188,20275,20276
20,3340,8109,4865,176,112,16602,20276,20278
20,217,126,523,17,20,903,20277,20279
20,110,196,397,7,4,714,20278,20280
20,16,56,42,1,2,117,20279,20281
20,36,250,53,1,1,341,20280,20282
20,58,129,114,34,8,343,20281,20283
20,82,318,289,11,5,705,20282,20284
20,117,585,413,10,7,1132,20283,20285
20,138,273,412,11,13,847,20284,20286
20,58,46,62,4,2,172,20285,20287
20,33,92,58,2,0,185,20286,20288
20,207,219,33,7,2,468,20287,20289
20,8,144,226,0,1,379,20288,20290
20,230,296,651,16,13,1206,20289,20291
20,39,368,29,9,5,450,20290,20292
20,949,602,1632,175,154,3512,20291,20293
20,590,984,1168,70,44,2856,20292,20294
20,949,1236,1262,76,46,3569,20293,20295
20,48,102,249,9,6,414,20294,20296
20,39,167,127,10,3,346,20295,20297
20,1249,1202,1675,106,129,4361,20296,20298
20,20,87,118,3,6,234,20297,20299
20,36,1141,1200,6,5,2388,20298,20300
20,110,138,214,9,10,481,20299,20301
20,52,703,531,5,2,1293,20300,20302
20,275,47,217,10,10,559,20301,20303
20,45,135,127,4,3,314,20302,20304
20,29,833,1242,15,7,2126,20303,20305
20,55,398,437,5,7,902,20304,20306
20,192,1847,1528,13,16,3596,20305,20307
20,0,0,0,0,0,0,20306,20308
20,1600,2020,878,14,18,4530,20307,20309
20,262,324,612,58,31,1287,20308,20310
20,11,136,52,5,2,206,20309,20311
20,227,1361,1390,10,18,3006,20310,20312
20,3,227,227,0,0,457,20311,20313
20,55,479,116,10,7,667,20312,20314
20,134,151,162,13,12,472,20313,20315
20,66,76,118,5,3,268,20314,20316
20,69,85,199,5,7,365,20315,20317
20,2897,4942,6054,157,128,14178,20316,20318
20,33,163,170,4,3,373,20317,20319
20,24,50,161,3,4,242,20318,20320
20,89,76,60,2,3,230,20319,20321
20,7,201,68,12,2,290,20320,20322
20,53,249,81,4,7,394,20321,20323
20,1926,4760,7512,207,178,14583,20322,20324
20,376,1522,919,53,32,2902,20323,20325
20,208,586,433,8,9,1244,20324,20326
20,846,2344,1167,33,22,4412,20325,20327
20,124,146,41,1,2,314,20326,20328
20,77,146,193,2,4,422,20327,20329
20,147,511,502,3,1,1164,20328,20330
20,41,62,154,4,9,270,20329,20331
20,27,89,78,0,5,199,20330,20332
20,306,236,300,19,17,878,20331,20333
20,1334,5363,6727,154,142,13720,20332,20334
20,223,540,433,10,23,1229,20333,20337
20,173,429,755,30,25,1412,20334,20339
20,147,354,377,14,14,906,20335,20340
20,8,94,126,1,1,230,20336,20335
20,136,112,334,21,15,618,20337,20336
20,14,62,23,0,2,101,20338,20341
20,168,152,274,22,22,638,20339,20342
20,174,186,182,10,12,564,20340,20343
20,241,577,72,10,5,905,20341,20344
20,34,691,779,15,12,1531,20342,20345
20,64,169,180,4,1,418,20343,20346
20,139,722,215,22,6,1104,20344,20347
20,328,462,1176,27,37,2030,20345,20348
20,109,295,205,9,8,626,20346,20349
20,1752,1532,2967,295,220,6766,20347,20350
20,271,277,156,17,17,738,20348,20351
20,21,526,60,8,2,617,20349,20352
20,109,204,173,5,6,497,20350,20534
20,75,159,242,7,7,490,20351,20535
20,67,129,22,3,4,225,20352,20536
20,172,364,40,8,2,586,20353,20353
20,21,100,54,3,3,181,20354,20354
20,14,124,124,1,5,268,20355,20355
20,103,167,162,12,13,457,20356,20356
20,110,229,40,3,4,386,20357,20357
20,129,341,263,15,13,761,20358,20358
20,30,91,170,5,10,306,20359,20359
20,199,475,418,28,21,1141,20360,20360
20,54,75,110,1,5,245,20361,20361
20,223,165,161,9,8,566,20362,20362
20,178,393,329,14,15,929,20363,20363
20,888,2657,2007,55,43,5650,20364,20364
20,106,230,274,16,18,644,20365,20365
20,115,317,496,7,96,1031,20366,20366
20,76,477,436,4,13,1006,20367,20367
20,163,180,208,17,4,572,20368,20368
20,102,177,294,15,11,599,20369,20369
20,18,74,70,0,1,163,20370,20074
20,25,115,112,3,3,258,20371,20370
20,41,94,223,6,5,369,20372,20371
20,42,86,365,11,4,508,20373,20372
20,31,109,84,0,2,226,20374,20373
20,22,174,244,2,1,443,20375,20374
20,949,914,1757,136,116,3872,20376,20375
20,8,91,35,1,2,137,20377,20376
20,161,1293,1777,17,24,3272,20378,20377
20,139,371,452,49,13,1024,20379,20378
20,52,172,414,7,8,653,20380,20379
20,75,172,259,12,11,529,20381,20380
20,87,485,455,4,4,1035,20382,20381
20,10,149,226,2,6,393,20383,20382
20,23,128,81,2,2,236,20384,20383
20,146,629,138,6,4,923,20385,20384
20,5011,5357,12475,1044,796,24683,20386,20385
20,469,910,1779,29,13,3200,20387,20386
20,69,521,671,35,14,1310,20388,20387
20,74,274,150,13,12,523,20389,20388
20,28,93,61,5,1,188,20390,20389
20,70,388,166,10,10,644,20391,20569
20,4697,4314,10418,902,735,21066,20392,20390
20,64,404,105,6,4,583,20393,20391
20,140,287,990,21,9,1447,20394,20392
20,119,457,146,16,9,747,20395,20393
20,6,40,3,0,0,49,20396,20047
20,62,184,437,5,7,695,20397,20394
20,35,207,253,14,8,517,20398,20395
20,64,537,152,3,0,756,20399,20396
20,1235,1010,3020,248,166,5679,20400,20399
20,58,285,357,10,3,713,20401,20400
20,51,84,167,1,2,305,20402,20404
20,178,209,284,20,16,707,20403,20405
20,781,3562,1874,19,41,6277,20404,20406
20,311,1047,667,13,14,2052,20405,20407
20,1200,2038,2897,70,69,6274,20406,20401
20,68,215,139,4,5,431,20407,20402
20,196,222,293,26,30,767,20408,20403
20,16,97,59,5,0,177,20409,20408
20,804,743,1571,134,142,3394,20410,20409
20,202,402,510,21,7,1142,20411,20410
20,31,105,93,5,11,245,20412,20411
20,53,506,240,5,0,804,20413,20412
20,2749,3932,5423,170,156,12430,20414,20413
20,238,1469,1898,54,32,3691,20415,20414
20,173,663,587,8,11,1442,20416,20415
20,13,268,25,5,0,311,20417,20416
20,703,983,1872,29,28,3615,20418,20417
20,187,2097,2271,290,11,4856,20419,20418
20,50,27,106,5,5,193,20420,20419
20,57,118,150,6,3,334,20421,20420
20,30,824,1036,8,12,1910,20422,20421
20,23,46,187,22,1,279,20423,20422
20,36,143,67,5,4,255,20424,20423
20,321,314,401,15,15,1066,20425,20424
20,56,227,345,7,6,641,20426,20425
20,817,2689,2046,61,39,5652,20427,20427
20,157,1106,791,5,13,2072,20428,20426
20,70,189,231,11,6,507,20429,20428
20,158,247,95,4,4,508,20430,20429
20,8,76,36,0,0,120,20431,20430
20,31,410,383,2,2,828,20432,20431
20,42,73,132,0,2,249,20433,20432
20,22,342,222,3,0,589,20434,20433
20,86,696,278,5,11,1076,20435,20434
20,87,266,149,15,13,530,20436,20435
20,24,136,258,1,5,424,20437,20436
20,272,214,802,61,69,1418,20438,20437
20,24,214,120,2,3,363,20439,20438
20,1136,2732,2701,68,56,6693,20440,20439
20,15,220,194,6,5,440,20441,20440
20,121,1093,1169,1,3,2387,20442,20441
20,31,44,95,2,1,173,20443,20442
20,24,69,84,18,1,196,20444,20443
20,22,29,82,0,0,133,20445,20444
20,14,57,298,3,2,374,20446,20445
20,231,500,846,30,48,1655,20447,20446
20,191,1184,2769,43,29,4216,20448,20447
20,30,119,159,3,3,314,20449,20448
20,259,286,586,23,17,1171,20450,20449
20,118,727,509,22,24,1400,20451,20450
20,49,202,216,3,6,476,20452,20451
20,400,292,246,24,31,993,20453,20452
20,56,564,762,8,6,1396,20454,20453
20,65,155,196,2,5,423,20455,20454
20,314,400,84,3,2,803,20456,20455
20,251,420,30,2,4,707,20457,20456
20,90,192,596,6,5,889,20458,20457
20,207,762,990,47,39,2045,20459,20459
20,161,793,345,3,6,1308,20460,20460
20,88,128,295,7,10,528,20461,20458
20,14,61,177,3,0,255,20462,20461
20,268,812,429,16,14,1539,20463,20462
20,22,112,165,1,3,303,20464,20463
20,40,32,94,1,8,175,20465,20464
20,68,283,67,1,2,421,20466,20465
20,72,772,2166,16,8,3034,20467,20466
20,426,2209,3601,241,73,6550,20468,20467
20,785,1293,1671,15,24,3788,20469,20468
20,879,2815,2772,118,129,6713,20470,20469
20,122,915,333,8,4,1382,20471,20470
20,22,51,170,0,5,248,20472,20471
20,23,928,604,10,8,1573,20473,20472
20,31,83,133,4,2,253,20474,20473
20,29,709,697,11,4,1450,20475,20474
20,527,664,846,49,29,2115,20476,20475
20,18,64,55,0,0,137,20477,20476
20,87,233,48,4,5,377,20478,20477
20,110,366,265,10,2,753,20479,20478
20,13,84,14,0,2,113,20480,20479
20,128,1229,1058,6,13,2434,20481,20066
20,18,173,119,2,6,318,20482,20480
20,69,91,402,8,18,588,20483,20481
20,1484,5660,8868,229,147,16388,20484,20482
20,488,1022,1381,79,60,3030,20485,20483
20,226,664,411,13,9,1323,20486,20484
20,147,465,179,2,14,807,20487,20485
20,128,236,278,13,10,665,20488,20487
20,3,87,10,0,0,100,20489,20488
20,180,774,500,7,11,1472,20490,20489
20,34,730,126,3,9,902,20491,20490
20,59,378,485,9,5,936,20492,20491
20,155,309,494,11,16,985,20493,20492
20,35,73,111,6,1,226,20494,20493
20,216,489,608,28,21,1362,20495,20494
20,68,294,310,6,9,687,20496,20495
20,107,252,270,7,8,644,20497,20496
20,107,655,408,5,6,1181,20498,20497
20,401,926,412,17,16,1772,20499,20498
20,101,62,527,12,18,720,20500,20499
20,247,852,1168,39,28,2334,20501,20500
20,19,70,199,5,7,300,20502,20501
20,236,374,406,19,11,1046,20503,20502
20,35,40,121,3,4,203,20504,20503
20,31,66,189,0,1,287,20505,20506
20,188,523,275,3,3,992,20506,20507
20,24,430,401,5,5,865,20507,20508
20,87,488,1039,18,5,1637,20508,20509
20,241,2246,1293,21,20,3821,20509,20505
20,11,405,62,1,3,482,20510,20510
20,124,626,282,8,5,1045,20511,20511
20,56,135,159,2,5,357,20512,20512
20,63,1719,1837,3,4,3626,20513,20513
20,18,117,23,0,1,159,20514,20514
20,2761,9390,10482,330,193,23156,20515,20515
20,151,360,642,14,9,1176,20516,20516
20,146,489,182,17,12,846,20517,20517
20,5,66,10,2,1,84,20518,20518
20,318,146,328,26,24,842,20519,20519
20,143,504,1376,27,24,2074,20520,20520
20,17,88,33,1,2,141,20521,20521
20,22,144,97,1,4,268,20522,20522
20,108,169,299,12,10,598,20523,20523
20,2,222,17,2,1,244,20524,20524
20,149,2411,1891,18,14,4483,20525,20525
20,133,617,234,20,16,1020,20526,20530
20,77,165,220,10,12,484,20527,20531
20,56,121,489,15,16,697,20528,20532
20,165,81,215,11,6,478,20529,20533
20,226,2723,1538,29,23,4539,20530,20526
20,42,295,178,0,1,516,20531,20527
20,16,25,406,1,3,451,20532,20528
20,24,120,62,3,1,210,20533,20529
20,216,1050,1175,18,25,2484,20534,20537
20,51,102,56,2,0,211,20535,20538
20,738,1545,1160,30,28,3501,20536,20277
20,254,593,998,55,32,1932,20537,20539
20,54,146,63,2,5,270,20538,20542
20,575,773,1495,92,80,3015,20539,20540
20,214,240,900,32,33,1419,20540,20031
20,25,295,310,1,0,631,20541,20541
20,112,359,611,10,14,1106,20542,20543
20,125,389,370,8,11,903,20543,20486
20,98,199,162,7,8,474,20544,20544
20,431,1611,1824,87,46,3999,20545,20545
20,612,276,1040,60,83,2071,20546,20546
20,37,49,282,4,12,384,20547,20547
20,82,149,266,13,6,516,20548,20548
20,668,1099,1483,51,48,3349,20549,20549
20,1244,1915,2729,205,180,6273,20550,20551
20,41,32,121,6,3,203,20551,20552
20,730,433,897,88,88,2236,20552,20553
20,908,3296,7486,160,173,12023,20553,20397
20,323,460,338,12,16,1149,20554,20554
20,131,246,449,22,17,865,20555,20555
20,15,31,62,1,4,113,20556,20556
20,416,1903,3439,48,23,5829,20557,20557
20,24,296,313,5,7,645,20558,20558
20,103,102,293,9,11,518,20559,20247
20,843,986,1921,153,107,4010,20560,20338
20,488,700,497,30,27,1742,20561,20560
20,35,200,274,6,4,519,20562,20038
20,94,348,167,8,5,622,20563,20561
20,53,539,38,1,0,631,20564,20563
20,61,255,49,1,1,367,20565,20564
20,1283,1857,5233,305,236,8914,20566,20565
20,70,375,265,7,9,726,20567,20566
20,302,381,152,2,7,844,20568,20567
20,42,327,77,7,2,455,20569,20568
20,1062,1940,3889,155,103,7149,20570,20570
21,5251,4286,4776,530,218,15061,21001,21001
21,917,962,1277,62,42,3260,21002,21002
21,2555,4153,3802,1689,135,12334,21003,21003
21,3265,4776,3588,482,160,12271,21004,21004
21,158,621,102,9,8,898,21005,21005
21,1459,1145,1641,181,23,4449,21006,21006
21,369,556,197,25,7,1154,21007,21007
21,975,776,1135,66,40,2992,21008,21008
21,47,350,362,52,3,814,21009,21009
21,3303,5799,2805,1330,103,13340,21010,21010
21,164,352,52,11,1,580,21011,21011
21,1082,835,309,53,26,2305,21012,21012
21,1706,1533,2022,311,45,5617,21013,21013
21,213,742,353,302,14,1624,21014,21014
21,9480,5614,5181,1060,460,21795,21015,21015
21,965,1031,538,44,28,2606,21016,21016
21,2052,1590,2030,535,85,6292,21017,21017
21,334,723,245,29,10,1341,21018,21018
21,20079,10727,10280,2658,834,44578,21019,21019
21,300,621,939,72,24,1956,21020,21020
21,83,300,80,12,2,477,21021,21021
21,619,1510,1179,75,13,3396,21022,21022
21,318,989,1351,49,7,2714,21023,21023
21,157,131,79,9,2,378,21024,21024
21,915,954,363,130,10,2372,21025,21025
21,1149,1674,995,138,78,4034,21026,21026
21,653,907,281,32,21,1894,21027,21027
21,315,339,141,161,6,962,21028,21028
21,1969,2366,1201,104,43,5683,21029,21099
21,101,691,346,392,21,1551,21030,21029
21,185,187,7,9,0,388,21031,21030
21,265,599,378,30,20,1292,21032,21031
21,109,324,76,24,6,539,21033,21032
21,598,556,204,37,12,1407,21034,21033
21,3611,2800,2749,260,171,9591,21035,21034
21,1272,2450,2337,670,62,6791,21036,21035
21,789,1459,984,75,28,3335,21037,21036
21,232,519,289,59,11,1110,21038,21037
21,595,847,586,52,24,2104,21039,21038
21,789,1066,549,355,18,2777,21040,21039
21,796,706,535,74,32,2143,21041,21040
21,8307,3951,5392,947,523,19120,21042,21041
21,133,799,370,27,3,1332,21043,21042
21,3111,3784,2662,2141,158,11856,21044,21043
21,1731,1729,1417,169,68,5114,21045,21044
21,6432,4668,2897,844,197,15038,21046,21045
21,971,815,278,34,12,2110,21047,21046
21,1413,2924,1624,501,79,6541,21048,21047
21,2076,2457,1090,136,72,5831,21049,21048
21,1203,1686,526,42,34,3491,21050,21049
21,1423,2424,1434,53,32,5366,21051,21050
21,2216,4698,4522,421,123,11980,21052,21051
21,166,313,87,19,8,593,21053,21052
21,6143,6261,4557,469,299,17729,21054,21053
21,2663,2537,1732,640,153,7725,21055,21054
21,233,766,789,61,6,1855,21056,21055
21,98,360,58,29,3,548,21057,21056
21,655,933,459,26,14,2087,21058,21057
21,2045,1711,746,53,40,4595,21059,21058
21,204,447,160,78,7,896,21060,21059
21,206,804,601,41,24,1676,21061,21060
21,663,1780,1502,31,14,3990,21062,21061
21,530,740,282,40,19,1611,21063,21062
21,1686,1506,1390,234,52,4868,21064,21063
21,1609,1931,1768,202,35,5545,21065,21064
21,1364,1017,1732,123,97,4333,21066,21065
21,335,1266,572,31,8,2212,21067,21066
21,2229,1737,676,49,46,4737,21068,21067
21,666,917,241,226,12,2062,21069,21068
21,2297,3015,1460,201,59,7032,21070,21069
21,928,883,642,33,13,2499,21071,21070
21,6744,9465,12273,2187,477,31146,21072,21071
21,1095,2567,1753,332,29,5776,21073,21072
21,998,1441,559,73,15,3086,21074,21073
21,571,848,389,49,18,1875,21075,21150
21,8139,5262,4114,968,396,18879,21076,21074
21,514,1275,1021,143,30,2983,21077,21075
21,3439,3399,1843,123,94,8898,21078,21076
21,303,922,173,501,16,1915,21079,21077
21,794,2021,396,339,13,3563,21080,21078
21,404,640,654,58,45,1801,21081,21079
21,144,378,376,171,6,1075,21082,21080
21,292,686,319,27,9,1333,21083,21081
21,567,1013,786,209,32,2607,21084,21082
21,2882,2894,2150,102,101,8129,21085,21083
21,244,777,675,358,17,2071,21086,21084
21,3097,7985,11970,1116,324,24492,21087,21085
21,1025,1474,1305,165,29,3998,21088,21086
21,643,1477,1853,46,15,4034,21089,21087
21,442,673,290,192,15,1612,21090,21088
21,988,1442,1125,38,13,3606,21091,21089
21,1891,1413,1802,260,108,5474,21092,21090
21,476,581,1962,179,52,3250,21093,21091
21,181,558,558,35,26,1358,21094,21092
21,833,1202,661,35,16,2747,21095,21093
21,3446,2933,2365,328,156,9228,21096,21094
21,126,115,10,0,0,251,21097,21095
21,358,357,138,6,9,868,21098,21096
21,234,418,146,23,10,831,21099,21097
21,185,790,1178,39,19,2211,21100,21098
21,900,1195,651,55,16,2817,21101,21100
21,222,521,188,232,17,1180,21102,21101
21,1336,1047,786,86,57,3312,21103,21102
21,277,803,600,29,17,1726,21104,21103
21,2507,1983,1022,155,74,5741,21105,21104
21,540,611,460,77,22,1710,21106,21105
21,1699,2055,2060,194,74,6082,21107,21106
21,1500,2093,361,289,22,4265,21108,21107
21,1859,1476,1041,117,52,4545,21109,21108
21,587,2193,2700,95,27,5602,21110,21109
21,4118,2497,3188,227,134,10164,21111,21110
21,1116,2376,2391,421,35,6339,21112,21111
21,623,1385,957,147,45,3157,21113,21112
21,139,881,822,163,9,2014,21114,21113
21,271198,154873,153657,36986,18230,634944,21115,21114
21,3838,2868,4409,308,206,11629,21116,21115
21,2328,2643,465,31,30,5497,21117,21116
21,2306,1843,855,139,101,5244,21118,21117
21,1605,1416,2091,249,78,5439,21119,21118
21,14222,5617,6274,1375,762,28250,21120,21119
21,89,602,665,13,9,1378,21121,21120
21,105,188,159,6,3,461,21122,21121
21,803,1217,597,236,47,2900,21123,21122
21,260,480,358,186,10,1294,21124,21123
21,1277,1833,2102,255,43,5510,21125,21124
21,1739,511,347,119,41,2757,21126,21125
21,361,540,462,53,15,1431,21127,21126
21,132,876,444,237,28,1717,21128,21127
21,550,826,645,73,31,2125,21129,21128
21,1098,1278,1889,36,14,4315,21130,21129
21,612,441,336,42,15,1446,21131,21130
21,120,154,40,6,4,324,21132,21131
21,20996,14534,10365,2822,1143,49860,21133,21132
21,11,130,124,8,1,274,21134,21133
21,2267,2100,1305,199,193,6064,21135,21134
21,63,197,28,5,2,295,21136,21135
21,1664,1199,829,227,118,4037,21137,21136
21,995,1185,646,38,27,2891,21138,21137
21,528,1203,1437,101,28,3297,21139,21138
21,67,607,748,54,3,1479,21140,21139
21,17496,10064,9395,3394,990,41339,21141,21140
21,394,710,263,64,9,1440,21142,21141
21,2551,1952,2844,331,190,7868,21143,21142
21,2930,2484,1918,419,146,7897,21144,21143
21,1072,1178,1178,105,37,3570,21145,21144
21,64,197,114,6,7,388,21146,21146
21,572,1054,336,129,26,2117,21147,21147
21,757,759,701,85,43,2345,21148,21148
21,1892,1913,1431,191,87,5514,21149,21149
21,774,884,744,122,47,2571,21150,21151
21,1000,1246,627,53,19,2945,21151,21152
21,2419,2024,2030,344,92,6909,21152,21153
21,5726,3621,9510,961,485,20303,21153,21154
21,263,1042,435,66,20,1826,21154,21155
21,36019,23587,20977,5890,1600,88073,21155,21156
21,710,1901,1177,384,26,4198,21156,21157
21,617,830,814,79,18,2358,21157,21158
21,476,873,201,18,12,1580,21158,21159
21,266,556,189,55,14,1080,21159,21160
21,1593,2060,1656,264,74,5647,21160,21161
21,422,483,320,289,7,1521,21161,21162
21,1150,1179,1331,153,66,3879,21162,21163
21,8688,6506,3901,1661,497,21253,21163,21164
21,28,170,47,3,0,248,21164,21165
21,524,967,756,112,23,2382,21165,21166
21,917,1023,446,235,20,2641,21166,21167
21,148,814,789,62,10,1823,21167,21168
21,1264,3211,1624,313,120,6532,21168,21169
21,1931,1977,1220,122,45,5295,21169,21170
21,278,321,530,78,17,1224,21170,21171
21,2475,3259,1842,184,117,7877,21171,21172
21,603,600,552,390,31,2176,21172,21173
21,13927,9297,7493,1585,823,33125,21173,21174
21,1020,1239,542,68,23,2892,21174,21175
21,558,1261,993,82,21,2915,21175,21176
21,3629,3540,3700,379,194,11442,21176,21177
21,1609,1792,532,46,22,4001,21177,21145
21,1658,1861,1390,103,25,5037,21178,21178
21,3880,2113,1756,262,124,8135,21179,21179
21,3012,4132,2656,217,144,10161,21180,21180
21,507,593,428,66,23,1617,21181,21181
21,343,441,546,44,17,1391,21182,21182
21,2884,2622,659,60,26,6251,21183,21183
21,1132,702,175,153,16,2178,21184,21184
21,745,737,762,49,30,2323,21185,21185
21,5168,5027,4157,791,321,15464,21186,21186
21,785,962,233,23,11,2014,21187,21187
21,1400,2311,845,71,25,4652,21188,21188
21,1712,894,2367,186,127,5286,21189,21189
21,59,271,127,32,7,496,21190,21190
21,397,1519,975,96,30,3017,21191,21191
21,684,757,214,361,8,2024,21192,21192
21,1020,1065,179,20,13,2297,21193,21193
21,2430,2416,2748,709,117,8420,21194,21194
21,1739,2790,1271,106,42,5948,21195,21195
21,85,297,190,137,9,718,21196,21196
21,9327,6282,5758,1377,321,23065,21197,21197
21,141,307,24,3,1,476,21198,21198
21,4314,3595,1819,205,142,10075,21199,21199
21,96,308,359,464,6,1233,21200,21200
21,341,366,233,16,6,962,21201,21201
21,867,953,389,805,37,3051,21202,21202
21,374,730,422,56,15,1597,21203,21203
21,226,796,792,389,27,2230,21204,21204
21,2604,1487,2091,167,94,6443,21205,21205
21,410,624,317,22,17,1390,21206,21206
21,3112,3956,2993,4129,159,14349,21207,21207
21,8178,7234,5709,2040,406,23567,21208,21208
21,777,1038,880,147,52,2894,21209,21209
21,383,572,519,448,10,1932,21210,21210
21,1504,1643,1723,510,128,5508,21211,21211
21,1166,1844,1468,848,50,5376,21212,21212
21,1213,1082,1736,136,37,4204,21213,21213
21,1823,1949,1211,278,48,5309,21214,21214
21,673,746,252,150,2,1823,21215,21215
21,213,340,114,106,3,776,21216,21216
21,803,1547,2489,70,31,4940,21217,21217
22,5306,5953,6011,1271,244,18785,22001,22001
22,1007,2010,1990,83,18,5108,22002,22003
22,8272,8269,2565,811,255,20172,22003,22004
22,9547,6083,1939,455,369,18393,22004,22005
22,20780,10402,6210,1777,908,40077,22005,22006
22,4973,4292,2171,780,203,12419,22006,22007
22,5859,3029,575,293,63,9819,22007,22008
22,4289,3456,792,243,67,8847,22008,22009
22,3506,2296,1182,62,48,7094,22009,22010
22,12767,10258,5972,705,467,30169,22010,22011
22,11018,5615,5040,708,286,22667,22011,22012
22,1739,3015,1676,59,34,6523,22012,22013
22,4278,3000,1590,76,34,8978,22013,22002
22,165090,70918,52994,10880,6269,306151,22014,22014
22,1047,1496,246,71,30,2890,22015,22015
22,41081,13877,16646,7722,1465,80791,22016,22016
22,9936,5712,5786,1401,497,23332,22017,22017
22,3786,3228,1668,291,113,9086,22018,22018
23,49325,44465,62056,6871,3909,166626,23001,23005
23,13772,14735,2417,668,203,31795,23002,23001
23,2197,13796,12722,621,135,29471,23003,23002
23,992,2742,2011,112,66,5923,23004,23003
23,2350,7096,4397,333,48,14224,23005,23006
23,1312,4636,3047,144,43,9182,23006,23007
23,16865,47722,17214,2480,775,85056,23007,23004
23,5307,12092,9762,670,548,28379,23008,23008
23,NA,NA,NA,NA,NA,NA,23009,23009
23,NA,NA,NA,NA,NA,NA,23010,23010
23,NA,NA,NA,NA,NA,NA,23011,23011
24,2876,2003,870,137,94,5980,24001,24001
24,1162,1402,423,139,47,3173,24002,24002
24,8386,4451,1549,72,83,14541,24003,24003
24,1017,768,169,29,41,2024,24004,24004
24,2229,2741,1982,208,98,7258,24005,24005
24,1845,1419,505,53,15,3837,24006,24006
24,2909,1943,997,328,267,6444,24007,24007
24,4113,3557,1001,50,35,8756,24008,24008
24,932,324,386,70,53,1765,24009,24009
24,5172,5755,723,50,53,11753,24010,24010
24,6075,5836,1204,1233,130,14478,24011,24011
24,2702,2445,2982,94,145,8368,24012,24012
24,29684,14577,11888,5141,824,62114,24013,24013
24,2206,2290,1965,88,36,6585,24014,24014
24,3060,3179,1306,319,68,7932,24015,24015
24,5437,4811,4539,398,110,15295,24016,24016
24,4089,4350,551,60,33,9083,24017,24017
24,3057,1998,637,129,19,5840,24018,24018
24,1054,788,584,8,11,2445,24019,24019
24,20093,9031,2158,1075,262,32619,24020,24020
24,7865,6061,1813,442,211,16392,24021,24021
24,2832,1624,1125,235,125,5941,24022,24022
24,2461,2419,1013,62,48,6003,24023,24023
24,16607,13029,3145,378,345,33504,24024,24024
24,4788,3036,1127,296,77,9324,24025,24025
24,2000,1513,439,12,15,3979,24026,24026
24,1912,2144,252,29,22,4359,24027,24027
24,161306,56627,42183,12997,6465,279578,24028,24028
24,3485,2377,2717,73,32,8684,24029,24029
24,1054,1042,735,21,7,2859,24030,24030
24,2618,1906,1021,256,107,5908,24031,24034
24,965,991,1116,12,16,3100,24032,24031
24,6220,4903,1577,221,156,13077,24033,24032
24,2181,1528,1497,156,38,5400,24034,24033
24,36071,14506,12818,5073,2373,70841,24035,24035
24,5229,3723,1325,189,100,10566,24036,24036
24,6711,10091,10242,2423,229,29696,24037,24037
24,2211,2118,1427,222,597,6575,24038,24038
24,2673,1579,1082,70,178,5582,24039,24039
24,6029,3300,3776,515,93,13713,24040,24040
24,2447,1722,2086,746,50,7051,24041,24041
24,3348,2642,385,75,21,6471,24042,24042
24,1692,1456,179,56,32,3415,24043,24043
24,1142,1603,139,51,7,2942,24044,24044
24,1923,2679,773,176,76,5627,24045,24045
24,2432,2042,967,34,20,5495,24046,24056
24,2003,1958,1983,128,72,6144,24047,24046
24,1905,945,409,297,20,3576,24048,24047
24,907,1075,261,30,8,2281,24049,24048
24,3693,4180,3716,222,54,11865,24050,24049
24,8565,5248,914,222,103,15052,24051,24050
24,3148,2493,374,41,25,6081,24052,24051
24,2123,2073,109,13,17,4335,24053,24052
24,5225,2895,2554,473,334,11481,24054,24053
24,6604,6872,1703,244,76,15499,24055,24054
24,3801,2367,1010,257,141,7576,24056,24055
24,3572,3082,634,490,34,7812,24057,24058
24,5008,1567,2957,315,57,9904,24058,24057
25,53020,59322,18681,8003,1094,140120,25001,25001
25,5215,9976,4599,233,72,20095,25002,25002
25,2410,6830,797,58,37,10132,25003,25003
25,4214,5405,960,58,46,10683,25004,25004
25,2248,3032,427,19,25,5751,25005,25005
25,103317,102796,52715,22788,3187,284803,25006,25006
25,5796,4440,531,103,17,10887,25007,25007
25,3728,8035,1202,64,41,13070,25008,25008
25,6886,7356,2760,586,136,17724,25009,25009
25,13059,15255,5256,919,160,34649,25010,25010
25,29325,39474,25988,8411,521,103719,25011,25011
25,64125,38506,35009,6667,1936,146243,25012,25012
25,6102,8968,2982,199,100,18351,25013,25013
25,5441,7854,3633,199,81,17208,25014,25014
25,9629,16221,4256,625,169,30900,25015,25015
25,2978,4216,943,57,38,8232,25016,25016
25,15826,12702,3192,127,89,31936,25017,25017
25,20967,17989,7908,906,371,48141,25018,25018
26,752,675,50,13,2,1492,26001,26001
26,11275,10340,3530,1512,198,26855,26002,26002
26,1494,783,970,32,19,3298,26003,26004
26,414,396,20,1,0,831,26004,26005
26,909,737,78,64,3,1791,26005,26006
26,285,258,24,1,1,569,26006,26007
26,429,291,23,7,0,750,26007,26008
26,511,451,28,9,3,1002,26008,26009
26,385,357,11,1,5,759,26009,26010
26,411,191,224,33,3,862,26010,26011
26,463,435,21,4,1,924,26011,26013
26,1234,1010,58,11,2,2315,26012,26014
26,421,197,127,1,2,748,26013,26015
26,1457,615,272,30,21,2395,26014,26016
26,5863,4273,2019,655,81,12891,26015,26019
26,388,247,16,11,1,663,26016,26022
26,1391,1462,77,29,11,2970,26017,26023
26,339,321,12,5,1,678,26018,26024
26,1625,1494,646,146,21,3932,26019,26027
26,490,472,40,5,5,1012,26020,26028
26,318,313,13,5,0,649,26021,26031
26,219,393,12,3,2,629,26022,26032
26,436,379,20,6,2,843,26023,26034
26,1719,1557,471,558,27,4332,26024,26035
26,4745,3244,1943,1120,59,11111,26025,26036
26,1236,1157,63,12,8,2476,26026,26038
26,1395,899,212,92,10,2608,26027,26039
26,479,501,23,1,1,1005,26028,26040
26,1740,1500,1724,59,215,5238,26029,26041
26,38387,17441,6219,2977,578,65602,26030,26043
26,69,210,35,0,3,317,26031,26046
26,1213,1659,94,13,8,2987,26032,26052
26,185,170,4,5,2,366,26033,26053
26,167,177,24,5,2,375,26034,26054
26,798,684,30,8,4,1524,26035,26057
26,3270,3092,692,127,65,7246,26036,26058
26,288,567,70,28,6,959,26037,26059
26,663,607,106,4,6,1386,26038,26060
26,745,635,124,11,1,1516,26039,26061
26,558,412,38,8,1,1017,26040,26062
26,170,358,345,4,1,878,26041,26063
26,372,443,25,3,1,844,26042,26064
26,458,453,78,2,1,992,26043,26065
26,390,590,77,3,3,1063,26044,26067
26,478,481,149,15,10,1133,26045,26068
26,14105,7417,3503,404,332,25761,26046,26017
26,758,1051,102,28,3,1942,26047,26020
26,970,604,48,15,1,1638,26048,26021
26,135513,81601,23488,10836,2459,253897,26049,26030
26,273,422,296,15,2,1008,26050,26037
26,692,387,316,4,2,1401,26051,26045
26,1570,1374,613,59,27,3643,26052,26047
26,6306,8711,1304,258,165,16744,26053,26048
26,717,578,33,5,3,1336,26054,26050
26,27859,14018,11367,1105,718,55067,26055,26055
26,946,639,329,20,9,1943,26056,26056
26,2061,2393,263,63,17,4797,26057,26066
26,2141,2707,3618,146,228,8840,26058,26012
26,76384,39148,22018,1410,1012,139972,26059,26018
26,4591,7368,7004,370,219,19552,26060,26025
26,15770,18807,12467,516,359,47919,26061,26029
26,3749,3603,1559,94,31,9036,26062,26003
26,9342,8475,5175,180,72,23244,26063,26026
26,10707,10761,9728,269,142,31607,26064,26033
26,15298,24854,14111,684,365,55312,26065,26042
26,88,207,183,2,2,482,26066,26044
26,915,914,77,8,2,1916,26067,26049
26,700,1474,215,22,4,2415,26068,26051
26,1309,1243,116,24,4,2696,26069,26069
26,1597,2304,992,73,51,5017,26070,26070
26,3567,3065,1882,50,40,8604,26071,26071
26,983,2020,1743,123,51,4920,26072,26072
27,1419,11502,8467,354,106,21848,27001,27001
27,3854,28787,56015,1619,595,90870,27002,27002
27,1735,18356,17498,1939,199,39727,27003,27003
27,13928,108860,131544,4896,2057,261285,27004,27004
27,3397,30723,45465,870,306,80761,27005,27005
27,2005,17983,25662,1200,241,47091,27006,27006
27,730,6301,6279,135,48,13493,27007,27007
27,2274,28176,30632,728,363,62173,27008,27008
27,507,8748,6925,88,54,16322,27009,27009
27,1071,13447,20639,467,141,35765,27010,27010
27,197,6550,7547,49,34,14377,27011,27011
27,2051,22619,38632,1199,439,64940,27012,27012
27,1113,16844,23659,709,298,42623,27013,27013
27,910,16962,19222,645,214,37953,27014,27014
27,635,8033,8635,111,71,17485,27015,27015
27,1552,8457,9656,234,530,20429,27016,27016
27,1287,10679,10346,329,130,22771,27017,27017
28,2070,1907,989,209,22,5197,28001,28001
28,5760,3647,2029,615,58,12109,28002,28002
28,22524,19979,8941,1943,731,54118,28003,28003
28,1473,1481,591,77,16,3638,28004,28004
28,750,1297,418,25,7,2497,28005,28005
28,681,2122,189,61,5,3058,28006,28006
28,1756,2221,1804,174,56,6011,28007,28007
28,648,1149,225,34,8,2064,28008,28008
28,32434,27450,22303,5212,1446,88845,28009,28009
28,259,909,138,17,3,1326,28010,28010
28,2037,1409,525,89,17,4077,28011,28011
28,7149,6704,2312,449,100,16714,28012,28012
28,1938,3788,975,162,41,6904,28013,28013
28,547,520,510,37,10,1624,28014,28014
28,1736,2261,1950,168,38,6153,28015,28015
28,3398,4795,1943,312,80,10528,28016,28016
28,1956,2970,702,362,16,6006,28017,28017
28,1178,1486,590,221,13,3488,28018,28018
28,2622,3737,1299,353,34,8045,28019,28019
28,314,1011,45,21,5,1396,28020,28020
28,16706,14815,13046,3090,491,48148,28021,28021
28,65688,57071,32291,4072,2173,161295,28022,28022
28,653,1121,666,37,11,2488,28023,28023
28,908,898,730,71,20,2627,28024,28024
28,3003,3849,3069,294,105,10320,28025,28025
28,298,890,186,33,1,1408,28026,28026
28,42465,54197,21130,3385,1457,122634,28027,28027
28,340,680,349,19,6,1394,28028,28028
28,2049,2531,778,296,18,5672,28029,28029
28,1771,2497,842,479,400,5989,28030,28030
28,214,421,117,17,3,772,28031,28031
28,73973,52045,37559,3909,1708,169194,28032,28032
28,10856,12073,19027,1880,939,44775,28033,28033
28,1116,1981,564,219,38,3918,28034,28034
28,6607,8290,8141,832,149,24019,28035,28035
28,114,426,4,5,0,549,28036,28036
28,3319,4133,1777,330,36,9595,28037,28037
28,59278,47387,25261,5200,1757,138883,28038,28038
28,2344,5913,883,527,47,9714,28039,28039
28,11414,7258,4903,905,255,24735,28040,28040
28,40068,48754,23198,8678,1415,122113,28041,28041
28,611,1864,383,64,3,2925,28042,28042
28,6036,3924,919,160,36,11075,28043,28043
29,1225,820,1452,138,67,3702,29001,29001
29,2099,1234,1752,382,100,5567,29002,29002
29,11542,4831,12073,1683,1101,31230,29003,29005
29,780,516,834,83,31,2244,29004,29003
29,2983,1075,1648,258,85,6049,29005,29004
29,5145,4238,5734,564,421,16102,29006,29006
29,1567,662,1458,216,76,3979,29007,29007
29,1970,717,1622,130,76,4515,29008,29008
29,775,387,794,44,20,2020,29009,29009
29,10033,4769,8477,1114,521,24914,29010,29010
29,606,271,639,52,31,1599,29011,29011
29,1031,469,1150,100,36,2786,29012,29012
29,11924,4429,7730,978,564,25625,29013,29013
29,2151,603,1390,293,66,4503,29014,29014
29,4128,2303,3908,806,233,11378,29015,29015
29,969,369,1003,150,91,2582,29016,29016
29,795,457,1403,84,33,2772,29017,29017
29,3877,2390,4345,462,255,11329,29018,29018
29,2445,807,2009,483,110,5854,29019,29019
29,1484,476,773,68,37,2838,29020,29020
29,2469,1119,1884,182,118,5772,29021,29021
29,787,388,923,35,19,2152,29022,29022
29,3404,1262,2168,439,121,7394,29023,29023
29,2538,1797,3439,1212,209,9195,29024,29024
29,7764,4446,7434,777,483,20904,29025,29025
29,2375,1205,2012,166,86,5844,29026,29026
29,774,871,1541,138,40,3364,29027,29027
29,2269,1643,2728,266,138,7044,29028,29028
29,1427,796,1468,122,68,3881,29029,29029
29,1512,800,1633,143,72,4160,29030,29030
29,3564,1297,2984,332,200,8377,29031,29031
29,1597,731,1193,248,47,3816,29032,29032
29,13911,7397,10968,1830,787,34893,29033,29033
29,4483,2682,5337,414,218,13134,29034,29034
29,640,316,671,82,29,1738,29035,29035
29,2698,2084,2773,367,128,8050,29036,29036
29,889,622,1315,104,57,2987,29037,29037
29,1197,567,1848,137,91,3840,29038,29038
29,1881,1420,2934,292,221,6748,29039,29039
29,1369,582,1293,105,71,3420,29040,29040
29,2447,1929,3624,473,214,8687,29041,29041
29,1690,715,1861,313,109,4688,29042,29042
29,3129,1120,3365,286,229,8129,29043,29043
29,4485,2219,5723,814,319,13560,29044,29044
29,582,172,365,124,15,1258,29045,29057
29,439,291,653,60,30,1473,29046,29059
29,546,211,627,136,28,1548,29047,29053
29,723,496,1304,107,52,2682,29048,29058
29,413,205,394,24,9,1045,29049,29060
29,511,559,845,54,40,2009,29050,29052
29,1409,756,1323,116,49,3653,29051,29050
29,2272,868,1964,144,61,5309,29052,29048
29,537,309,578,267,32,1723,29053,29049
29,588,250,596,27,8,1469,29054,29046
29,417,141,303,20,12,893,29055,29047
29,376,314,385,170,22,1267,29056,29051
29,383,155,406,68,26,1038,29057,29055
29,992,328,816,122,21,2279,29058,29056
29,479,265,672,119,29,1564,29059,29054
29,774,366,614,49,21,1824,29060,29045
30,783,1216,588,146,33,2766,30001,30001
30,502,374,204,33,7,1120,30002,30002
30,11318,10336,8812,532,293,31291,30003,30003
30,6047,4752,4688,379,208,16074,30004,30004
30,704,1167,414,13,12,2310,30005,30005
30,1754,2025,2164,165,54,6162,30006,30006
30,979,1206,467,168,15,2835,30007,30007
30,10227,8154,15621,1365,367,35734,30008,30160
30,1120,1422,309,31,27,2909,30009,30008
30,3263,4167,3885,197,101,11613,30010,30009
30,4115,6753,4657,487,256,16268,30011,30010
30,7750,8014,2799,862,306,19731,30012,30011
30,1258,1331,724,37,21,3371,30013,30012
30,6353,5525,3744,296,122,16040,30014,30014
30,3333,3976,3147,147,76,10679,30015,30013
30,3716,4768,4051,177,102,12814,30016,30015
30,3969,3573,2846,596,149,11133,30017,30016
30,444,769,526,16,20,1775,30018,30017
30,321,235,172,0,0,728,30019,30018
30,770,741,215,6,6,1738,30020,30019
30,879,1016,1431,34,23,3383,30021,30020
30,3739,2533,2712,277,55,9316,30022,30021
30,2453,3128,1472,121,86,7260,30023,30022
30,7808,5797,2759,145,63,16572,30024,30023
30,1618,1423,893,165,38,4137,30025,30024
30,2153,2838,1116,210,52,6369,30026,30025
30,2039,2110,2312,361,187,7009,30027,30026
30,1250,2349,1968,28,38,5633,30028,30027
30,32359,19028,14407,1984,1042,68820,30029,30028
30,1298,1432,593,27,37,3387,30030,30029
30,3698,3605,5658,715,237,13913,30031,30030
30,2142,1836,1927,136,64,6105,30032,30031
30,2145,2610,2540,147,43,7485,30033,30157
30,3571,5221,7038,245,146,16221,30034,30032
30,3557,4057,1789,124,53,9580,30035,30033
30,3020,2660,4191,340,208,10419,30036,30034
30,2008,2112,434,29,21,4604,30037,30035
30,922,1280,866,101,20,3189,30038,30036
30,779,895,831,13,23,2541,30039,30037
30,9161,14869,7925,1410,652,34017,30040,30038
30,24395,43860,45284,2588,1272,117399,30041,30039
30,7368,3203,6205,357,110,17243,30042,30040
30,218,384,250,4,5,861,30043,30041
30,651,779,784,31,17,2262,30044,30042
30,2989,2335,501,354,20,6199,30045,30043
30,36214,26171,18302,2319,991,83997,30046,30044
30,8755,7988,6310,543,205,23801,30047,30045
30,2168,1930,1104,163,63,5428,30048,30046
30,4608,5950,1830,227,147,12762,30049,30047
30,7606,13376,18768,617,433,40800,30050,30048
30,3049,2174,2652,237,74,8186,30051,30049
30,2112,1256,1669,39,32,5108,30052,30050
30,1058,3106,3377,66,34,7641,30053,30051
30,1237,2098,1057,50,34,4476,30054,30052
30,3841,2946,2658,200,122,9767,30055,30053
30,1020,2684,1780,53,34,5571,30056,30054
30,1587,924,2488,52,23,5074,30057,30055
30,805,696,1013,25,15,2554,30058,30056
30,1802,1127,956,50,41,3976,30059,30057
30,4282,6698,7505,500,310,19295,30060,30058
30,1347,2518,2269,42,45,6221,30061,30059
30,1895,2032,1103,27,15,5072,30062,30060
30,7696,7650,6331,318,204,22199,30063,30061
30,1988,2581,1672,59,53,6353,30064,30062
30,2700,3120,356,14,16,6206,30065,30063
30,312,376,559,23,9,1279,30066,30064
30,7277,5715,5465,878,350,19685,30067,30065
30,1563,2909,4024,92,53,8641,30068,30066
30,1623,1556,1168,13,10,4370,30069,30067
30,9946,7094,5777,674,273,23764,30070,30068
30,1460,1747,6114,90,63,9474,30071,30069
30,2606,2297,1423,26,24,6376,30072,30070
30,6609,6583,2730,2509,240,18671,30073,30071
30,1230,2648,2425,180,65,6548,30074,30072
30,3798,5707,4747,147,117,14516,30075,30073
30,957,861,768,68,33,2687,30076,30074
30,2637,3173,995,87,31,6923,30077,30075
30,1874,1085,957,37,25,3978,30078,30076
30,6657,3971,2385,189,106,13308,30079,30077
30,2019,2880,481,22,27,5429,30080,30078
30,1505,1305,329,33,18,3190,30081,30079
30,2851,4974,6795,217,134,14971,30082,30083
30,2048,2115,2126,382,71,6742,30083,30080
30,939,1909,3238,47,26,6159,30084,30082
30,1451,1964,1051,125,86,4677,30085,30081
30,1038,1138,500,40,20,2736,30086,30084
30,9300,7169,6300,552,279,23600,30087,30085
30,3761,2873,2759,271,156,9820,30088,30086
30,40772,76710,60346,5759,3793,187380,30089,30087
30,265,607,1044,24,7,1947,30090,30088
30,3625,6303,6384,299,145,16756,30091,30089
30,1955,1443,468,124,23,4013,30092,30090
30,2381,3523,2817,97,78,8896,30093,30091
30,1381,2130,1281,172,72,5036,30094,30093
30,6503,5667,1049,51,48,13318,30095,30094
30,1682,2378,1782,70,56,5968,30096,30095
30,428,414,38,2,2,884,30097,30096
30,2516,2780,2321,263,63,7943,30098,30097
30,249,564,282,2,0,1097,30099,30098
30,1608,1525,1316,77,49,4575,30100,30099
30,3091,2791,2065,352,44,8343,30101,30100
30,2743,3675,3266,285,113,10082,30102,30101
30,12512,9898,9952,1411,240,34013,30103,30102
30,1029,899,1082,18,9,3037,30104,30103
30,1094,2473,2106,115,40,5828,30105,30104
30,6302,4167,3018,621,154,14262,30106,30105
30,425,369,560,19,8,1381,30107,30106
30,194,398,269,8,4,873,30108,30107
30,14078,22543,30909,783,472,68785,30109,30108
30,8146,6454,6441,1705,149,22895,30110,30109
30,767,1443,232,30,22,2494,30111,30110
30,884,2460,2952,54,43,6393,30112,30111
30,3460,2072,1921,310,86,7849,30113,30112
30,538,828,349,20,5,1740,30114,30113
30,814,1301,1575,111,16,3817,30115,30114
30,4459,7293,5475,401,181,17809,30116,30115
30,1732,1577,1870,72,45,5296,30117,30116
30,2790,4525,1264,82,73,8734,30118,30117
30,23513,18879,16253,2124,980,61749,30119,30118
30,578,985,725,38,15,2341,30120,30119
30,729,1693,2023,20,20,4485,30121,30120
30,4126,2812,749,86,28,7801,30122,30121
30,1823,2073,1697,64,42,5699,30123,30122
30,15250,11535,7327,539,288,34939,30124,30123
30,15720,13751,27065,918,550,58004,30125,30124
30,2311,3873,4709,399,92,11384,30126,30125
30,5146,3038,3781,415,83,12463,30127,30126
30,1343,3031,682,38,33,5127,30128,30127
30,5431,11509,2658,693,258,20549,30129,30128
30,2388,1925,1918,107,27,6365,30130,30129
30,6057,5600,3730,90,123,15600,30131,30130
30,29697,16734,29092,2070,644,78237,30132,30131
30,9324,4312,4695,512,195,19038,30133,30133
30,2418,2322,2475,346,78,7639,30134,30134
30,2952,2236,1309,148,52,6697,30135,30135
30,695,1069,636,48,32,2480,30136,30136
30,1625,2285,1306,227,175,5618,30137,30132
30,679,875,150,35,4,1743,30138,30137
30,5902,6907,5799,627,267,19502,30139,30138
30,564,780,1018,49,8,2419,30140,30139
30,359,437,133,2,1,932,30141,30140
30,11568,17745,20193,792,392,50690,30142,30141
30,4083,4445,2718,57,54,11357,30143,30142
30,2227,10368,8032,112,73,20812,30144,30143
30,3154,3832,3783,88,60,10917,30145,30144
30,1059,2003,1406,37,35,4540,30146,30145
30,665,498,156,77,10,1406,30147,30146
30,663,2715,3442,40,24,6884,30148,30147
30,4658,2917,2497,370,63,10505,30149,30148
30,2933,3894,3098,184,92,10201,30150,30149
30,1739,2570,351,18,13,4691,30151,30150
30,3113,3846,1953,277,69,9258,30152,30151
30,2607,1519,721,34,25,4906,30153,30152
30,679,776,1095,14,7,2571,30154,30153
30,2602,2132,501,17,17,5269,30155,30154
30,18218,12437,4583,344,161,35743,30156,30155
30,683,709,218,20,5,1635,30157,30156
30,1600,3161,5274,114,58,10207,30158,30158
30,1415,1908,1994,45,38,5400,30159,30159
30,3722,3813,5222,54,335,13146,30160,30161
30,909,1036,208,105,11,2269,30161,30162
30,776,823,395,6,6,2006,30162,30163
30,1526,2321,1989,153,88,6077,30163,30164
30,1544,890,661,115,22,3232,30164,30165
30,1142,1191,723,71,38,3165,30165,30166
30,1649,1971,1835,149,69,5673,30166,30167
30,1165,1802,968,102,31,4068,30167,30168
30,4124,2331,2064,84,48,8651,30168,30169
30,255,1408,1856,54,10,3583,30169,30170
30,912,598,222,67,12,1811,30170,30171
30,3113,2187,2310,60,30,7700,30171,30172
30,5766,6493,4978,165,151,17553,30172,30173
30,12790,8724,13511,957,314,36296,30173,30174
30,11671,7151,8342,828,241,28233,30174,30175
30,417,835,682,14,5,1953,30175,30176
30,880,1259,1202,69,32,3442,30176,30177
30,2386,1656,1975,124,49,6190,30177,30178
30,464,489,186,58,3,1200,30178,30179
30,755,1199,1880,60,26,3920,30179,30180
30,5213,4442,4213,360,119,14347,30180,30181
30,1238,1597,1010,180,99,4124,30181,30182
30,6179,4339,5151,618,210,16497,30182,30183
30,602,824,661,18,10,2115,30183,30184
30,710,655,485,27,16,1893,30184,30185
30,1196,893,477,50,42,2658,30185,30186
30,616,407,410,15,7,1455,30186,30187
30,2582,2128,644,289,27,5670,30187,30188
30,22133,12870,11830,2344,793,49970,30188,30189
30,267,465,307,5,4,1048,30189,30190
30,4316,3884,3616,550,170,12536,30190,30191
30,1935,2827,1871,122,55,6810,30191,30192
30,95329,62460,48123,6140,2779,214831,30192,30193
30,948,1318,521,126,26,2939,30193,30194
30,1966,4983,4105,378,138,11570,30194,30092
30,356,1003,439,8,7,1813,30195,30195
30,2350,2355,2273,142,93,7213,30196,30196
30,1168,1282,1739,120,17,4326,30197,30197
30,736,566,1377,22,14,2715,30198,30198
30,303,1751,1908,42,7,4011,30199,30199
30,2585,2132,750,226,34,5727,30200,30200
30,3584,4764,2157,977,110,11592,30201,30201
30,912,945,1816,22,40,3735,30202,30202
30,2147,1661,858,14,14,4694,30203,30203
30,5727,5106,5666,438,153,17090,30204,30207
30,1026,6046,6120,410,72,13674,30205,30206
30,2381,5629,11317,368,168,19863,30206,30204
30,1997,3148,2139,259,46,7589,30207,30205
30,3324,3138,2030,158,133,8783,30208,30208
30,3141,2963,1783,52,53,7992,30209,30210
30,684,2436,2010,101,31,5262,30210,30209
30,4848,3171,2856,273,66,11214,30211,30211
30,1286,1239,1300,11,18,3854,30212,30212
31,1755,872,209,26,13,2875,31001,31001
31,2361,3162,507,122,44,6196,31002,31002
31,1454,1670,382,99,22,3627,31003,31003
31,973,1363,199,76,22,2633,31004,31004
31,510,592,24,5,4,1135,31005,31005
31,1951,1897,207,100,15,4170,31006,31006
31,1207,960,370,43,16,2596,31007,31007
31,612,695,561,6,4,1878,31008,31008
31,1079,718,353,122,9,2281,31009,31009
31,457,461,23,2,4,947,31010,31010
31,678,1011,392,182,25,2288,31011,31011
31,850,834,38,9,3,1734,31012,31012
31,1750,1794,272,68,22,3906,31013,31013
31,399,392,18,0,1,810,31014,31014
31,884,927,149,49,8,2017,31015,31015
31,518,542,22,1,0,1083,31016,31016
31,1141,1106,33,4,1,2285,31017,31017
31,636,638,102,15,3,1394,31018,31018
31,6045,3555,1384,12,17,11013,31019,31019
31,759,904,63,26,5,1757,31020,31020
31,1491,1354,236,10,2,3093,31021,31021
31,1022,876,8,0,0,1906,31022,31022
31,770,1134,168,40,17,2129,31023,31023
31,623,465,129,6,8,1231,31024,31024
31,1140,868,133,10,9,2160,31025,31025
31,676,1070,126,46,6,1924,31026,31026
31,1467,1631,583,206,23,3910,31027,31027
31,499,577,120,17,2,1215,31028,31028
31,1208,1115,638,35,12,3008,31029,31029
31,763,855,54,9,2,1683,31030,31030
31,758,799,25,12,1,1595,31031,31031
31,3204,1900,654,27,21,5806,31032,31032
31,2715,3472,1645,370,68,8270,31033,31033
31,1225,970,250,34,15,2494,31034,31034
31,1421,937,148,36,6,2548,31035,31035
31,1346,1122,526,78,19,3091,31036,31036
31,989,774,94,22,8,1887,31037,31037
31,5903,3926,799,291,117,11036,31038,31038
31,710,823,82,28,12,1655,31039,31039
31,4173,5223,1284,259,92,11031,31040,31040
31,7733,8386,2225,584,246,19174,31041,31041
31,955,901,126,11,5,1998,31042,31042
31,537,696,61,0,0,1294,31043,31043
31,869,1193,241,55,15,2373,31044,31044
31,361,618,64,17,6,1066,31045,31045
31,611,626,73,1,5,1316,31046,31046
31,1024,962,133,24,5,2148,31047,31047
31,2487,3563,2421,194,63,8728,31048,31048
31,643,452,8,0,1,1104,31049,31049
31,168201,100803,45000,14521,5937,334462,31050,31050
31,690,799,79,30,6,1604,31051,31051
31,7198,5110,1351,430,163,14252,31052,31052
31,1531,1714,568,151,41,4005,31053,31053
31,553,654,80,96,3,1386,31054,31054
31,833,992,241,37,7,2110,31055,31055
31,3850,4167,972,286,57,9332,31056,31056
31,1918,1340,241,62,8,3569,31057,31057
31,2814,2951,1195,114,29,7103,31058,31058
31,7286,11298,2815,495,358,22252,31059,31059
31,129,239,183,0,1,552,31060,31060
31,813,625,152,11,3,1604,31061,31061
31,723,1202,110,66,14,2115,31062,31062
31,915,742,516,56,6,2235,31063,31063
31,397,423,45,25,1,891,31064,31064
31,671,350,24,8,2,1055,31065,31065
31,682,737,78,4,3,1504,31066,31066
31,1507,1554,214,79,23,3377,31067,31067
31,725,738,131,36,6,1636,31068,31068
31,1294,1270,114,7,7,2692,31069,31069
31,878,906,237,10,2,2033,31070,31070
31,356,330,102,5,4,797,31071,31071
31,192,428,408,15,4,1047,31072,31072
31,433,562,267,1,0,1263,31073,31073
31,855,792,126,30,8,1811,31074,31074
31,932,886,131,8,12,1969,31075,31075
31,2719,3074,412,135,36,6376,31076,31076
31,581,496,41,22,1,1141,31077,31077
31,980,888,145,31,7,2051,31078,31078
31,6048,6140,1595,322,81,14186,31079,31079
31,2109,1818,199,75,24,4225,31080,31080
31,725,656,50,0,2,1433,31081,31081
31,666,876,73,254,4,1873,31082,31082
31,301,398,101,9,3,812,31083,31083
31,1598,1837,110,23,13,3581,31084,31084
31,2132,2691,948,23,25,5819,31085,31085
31,333,468,220,15,2,1038,31086,31086
31,1046,570,193,58,10,1877,31087,31087
31,423,509,25,15,2,974,31088,31088
31,6116,5691,1739,373,97,14016,31089,31089
31,1341,1291,56,17,5,2710,31090,31090
31,1969,1790,751,39,23,4572,31091,31091
31,1070,1379,92,9,4,2554,31092,31092
31,3118,3187,1032,167,72,7576,31093,31093
31,454,611,816,4,2,1887,31094,31094
31,1320,856,305,52,19,2552,31095,31095
31,14134,9029,2765,330,132,26390,31096,31096
31,785,734,62,9,3,1593,31097,31097
31,1336,1842,1253,57,23,4511,31098,31098
31,695,557,35,1,0,1288,31099,31099
31,638,492,71,21,8,1230,31100,31100
31,8558,7147,1825,491,254,18275,31101,31101
31,10626,9218,5294,370,149,25657,31102,31102
31,544,554,72,18,7,1195,31103,31103
31,2287,2968,224,8,18,5505,31104,31104
31,355,710,167,23,7,1262,31105,31105
31,411,564,196,23,3,1197,31106,31106
32,904,566,976,113,26,2585,32001,32001
32,532,845,397,34,27,1835,32002,32002
32,516,201,527,27,14,1285,32003,32003
32,707,510,291,31,11,1550,32004,32004
32,3344,2253,3762,553,232,10144,32005,32005
32,844,548,1424,176,57,3049,32006,32006
32,1000,1990,1649,279,75,4993,32007,32007
32,763,1114,1121,96,38,3132,32008,32008
32,1563,1179,830,137,56,3765,32009,32009
32,16539,15274,33096,2590,1446,68945,32010,32010
32,362,337,423,41,17,1180,32011,32011
32,1122,484,864,62,25,2557,32012,32012
32,631,574,828,75,32,2140,32013,32013
32,3011,2006,2703,109,46,7875,32014,32014
32,252,202,335,26,6,821,32015,32015
32,1834,1830,2971,310,133,7078,32016,32016
32,12834,9761,16529,4155,1618,44897,32017,32017
32,684,539,639,54,36,1952,32018,32018
32,3848,1769,2780,434,167,8998,32019,32019
32,6962,4534,7075,1905,521,20997,32020,32020
32,298,534,735,43,11,1621,32021,32021
32,2880,1404,2033,187,144,6648,32022,32022
32,1735,1281,1810,373,164,5363,32023,32023
32,3724,2866,5030,888,400,12908,32024,32024
32,1033,1148,1715,152,76,4124,32025,32025
32,672,2332,2609,82,46,5741,32026,32026
32,54,549,423,8,6,1040,32027,32027
32,290,423,404,18,6,1141,32028,32028
32,2397,1056,2236,168,87,5944,32029,32029
32,467,202,143,10,3,825,32030,32030
32,1189,1718,879,125,46,3957,32031,32031
32,1458,942,1327,230,92,4049,32032,32032
32,844,579,580,53,32,2088,32033,32033
32,4724,2685,2683,666,215,10973,32034,32034
32,885,1708,2205,150,63,5011,32035,32035
32,3432,3836,3361,812,308,11749,32036,32036
32,1573,980,1642,151,59,4405,32037,32037
32,3517,12478,6727,267,207,23196,32038,32038
32,6230,7500,6052,814,548,21144,32039,32039
32,1740,2496,2756,164,77,7233,32040,32040
32,80,434,638,23,7,1182,32041,32041
32,6362,7284,6145,555,293,20639,32042,32042
32,203,121,193,20,11,548,32043,32043
32,2263,1646,1641,197,63,5810,32044,32044
32,688,1196,1704,83,19,3690,32045,32045
32,921,1212,1099,97,31,3360,32046,32046
32,1140,1046,1340,86,42,3654,32047,32047
32,2672,1935,3045,356,157,8165,32048,32048
32,3833,3721,4663,462,163,12842,32049,32049
32,904,732,1452,131,48,3267,32050,32050
32,3093,2499,5051,426,169,11238,32051,32051
32,834,2193,2989,286,118,6420,32052,32052
32,888,1402,1991,162,57,4500,32053,32053
32,865,1965,2926,134,56,5946,32054,32054
32,3833,3002,3097,735,187,10854,32055,32055
32,15873,13085,19136,4592,2023,54709,32056,32056
32,880,1599,2012,203,78,4772,32057,32057
32,NA,NA,NA,NA,NA,NA,32058,32058
